ؠ	ʲ
آب	aː b
آزاد	aː z aː d
بوی	b oː j
ترٛےٚ	t r e
خلق	kʰ a l ɨ k
دۄد	d ɔ d
روٗد	r uː d
زؠو	zʲ a w
زیٛو	zʲ a w
شال	ʃ aː l
شمال	ʃ ɨ m aː l
ماس	m aː s
مام	m aː m
موج	m oː d͡ʒ
مول	m oː l
ووٗنٛٹ	w ũː ʈ
ٟ	ɨː
ٲ	əː
ٲٹھ	əː ʈʰ
ٳ	ɨː
پانٛژھ	p ãː n t͡sʰ
چھہ	t ʃʰ ə
ژور	t͡s oː r
ژوٗنٛٹھ	t͡s ũː ʈʰ
ژۄداہ	t͡s ɔ d aː h
کوه	k ɔ h
کوٗر	k uː r
کٲم	k əː m
گام	ɡ aː m
