אזיר	a z e ɾ
איגזירסיטו	e ɡ z e r s i t o
איגזירסיטוס	e ɡ z e r s i t o s
ארפה	a ɾ p a
הלכה	a l a x a
טודו	t o ð o
טראבﬞאזﬞו	t ɾ a v a ʒ o
טראבﬞאזﬞוס	t ɾ a v a ʒ o s
לואר	l o a ɾ
לשון	l a ʃ ɔ n
מוּז׳יר	m u ʒ e ɾ
מואיבﬞו	m w e v o
מילדאר	m ɛ l d a ɾ
נון	n o n
סיב'דאד	s i v d a d
סין	s i n
פאלאברה	p a l a v ɾ a
פﬞאמברי	f a m b ɾ e
פﬞאמבריס	f a m b ɾ e s
קון	k o n
קוסמופוליטו	k o s m o p o l i t o
