ace	ʔ ɛ ɲ ˧˧ t͡ɕ ɪ j ˨˩ ʔ ʔ ɛ m ˧˧
actini	ʔ aː k̚ ˦˧˥ t ɪ j ˧˧ n ɪ j ˧˧
adn	ʔ aː ˧˧ ʔ ɗ e j ˧˧ ʔ ɛ ŋ ˧˧
agon	ʔ aː ˧˧ ɣ ə w ŋ͡m ˧˧
ai	ʔ aː j ˧˧
alexanđê	ʔ aː ˧˧ l ɛ k̚ ˦˧˥ s aː ŋ ˧˧ ʔ ɗ e j ˧˧
am	ʔ aː m ˧˧
ambrôsiô	ʔ aː m ˧˧ ʔ ɓ ɹ o w ˧˧ s ɪ j ˧˧ ʔ o w ˧˧
amerixi	ʔ aː ˧˧ m e j ˧˧ ɹ ɪ j ˧˧ s ɪ j ˧˧
amoni	ʔ aː ˧˧ m o w ˧˧ n ɪ j ˧˧
an	ʔ aː ŋ ˧˧
ancol	ʔ aː n ˧˧ k o n ˧˧
ang	ʔ aː ŋ ˧˧
anh	ʔ ɛ ɲ ˧˧
anphongsô	ʔ aː ŋ ˧˧ f a w ŋ͡m ˧˧ ʂ o w ˧˧
anphonsô	ʔ aː ŋ ˧˧ f ɔ ŋ ˧˧ ʂ o w ˧˧
anrê	ʔ aː ŋ ˧˧ ʐ e j ˧˧
antimon	ʔ aː ŋ ˧˧ t ɪ j ˧˧ m ɔ ŋ ˧˧
antôn	ʔ aː ŋ ˧˧ t o ŋ ˧˧
anê	ʔ aː ŋ ˧˧ n e j ˧˧
ao	ʔ aː w ˧˧
asen	ʔ aː ˧˧ s ɛ n ˧˧
atatin	ʔ aː ˧˧ t aː ˧˧ t i n ˧˧
au	ʔ a w ˧˧
augustinô	ʔ a w ˧˧ ɣ ʊ w ˧˧ s t i n ˧˧ n o w ˧˧
axit	ʔ aː ˧˧ s i t̚ ˦˧˥
axít	ʔ aː ˧˧ s i t̚ ˦˧˥
b	ʔ ɓ e j ˧˧
ba	ʔ ɓ aː ˧˧
ban	ʔ ɓ aː ŋ ˧˧
bang	ʔ ɓ aː ŋ ˧˧
banh	ʔ ɓ ɛ ɲ ˧˧
bao	ʔ ɓ aː w ˧˧
bari	ʔ ɓ aː ˧˧ ɹ ɪ j ˧˧
batôlômêô	ʔ ɓ aː ˧˧ t o w ˧˧ l o w ˧˧ m e j ˧˧ ʔ o w ˧˧
bay	ʔ ɓ a j ˧˧
bazơ	ʔ ɓ aː ˧˧ z əː ˧˧
be	ʔ ɓ ɛ ˧˧
beckeli	ʔ ɓ ɛ k̚ ˦˧˥ k e j ˧˧ l ɪ j ˧˧
beo	ʔ ɓ ɛ w ˧˧
beri	ʔ ɓ ɛ ˧˧ ɹ ɪ j ˧˧
berili	ʔ ɓ ɛ ˧˧ ɹ ɪ j ˧˧ l ɪ j ˧˧
bi	ʔ ɓ ɪ j ˧˧
bia	ʔ ɓ i ə ˧˧
binh	ʔ ɓ ɨ n ˧˧
bismut	ʔ ɓ i t̚ ˧˧ m ʊ k̚ ˧˧
bit	ʔ ɓ i t̚ ˧˧
bitmut	ʔ ɓ i t̚ ˧˧ m ʊ k̚ ˧˧
biên	ʔ ɓ i ə ŋ ˧˧
biếc	ʔ ɓ i ə k̚ ˦˧˥
biến	ʔ ɓ i ə ŋ ˦˧˥
biếng	ʔ ɓ i ə ŋ ˦˧˥
biết	ʔ ɓ i ə k̚ ˦˧˥
biếu	ʔ ɓ i w ˨˩˦
biền	ʔ ɓ i ə ŋ ˦˩
biển	ʔ ɓ i ə ŋ ˧˨
biểu	ʔ ɓ i w ˧˨
biện	ʔ ɓ i ə ŋ ˨˩ ʔ
biệt	ʔ ɓ i ə k̚ ˨˩ ʔ
blu	ʔ ɓ l ʊ w ˧˧
bo	ʔ ɓ ɔ ˧˧
boa	ʔ ɓ w aː ˧˧
bom	ʔ ɓ ɔ m ˧˧
bon	ʔ ɓ ɔ ŋ ˧˧
bong	ʔ ɓ a w ŋ͡m ˧˧
boong	ʔ ɓ ɔ ŋ͡m ˧˧
brigitta	ʔ ɓ ɹ ɪ j ˧˧ j i t̚ ˦˧˥ t aː ˧˧
brom	ʔ ɓ ɹ o m ˧˧
brâu	ʔ ɓ ɹ ə w ˧˧
bu	ʔ ɓ ʊ w ˧˧
bung	ʔ ɓ ʊ w ŋ͡m ˧˧
buôn	ʔ ɓ u ə ŋ ˧˧
buông	ʔ ɓ u ə ŋ ˧˧
buýt	ʔ ɓ w ɨ t̚ ˦˧˥
buốt	ʔ ɓ u ə k̚ ˦˧˥
buồi	ʔ ɓ u j ˦˩
buồm	ʔ ɓ u ə m ˦˩
buồn	ʔ ɓ u ə ŋ ˦˩
buồng	ʔ ɓ u ə ŋ ˦˩
buổi	ʔ ɓ u j ˧˨
buộc	ʔ ɓ u ə k̚ ˨˩ ʔ
buột	ʔ ɓ u ə k̚ ˨˩ ʔ
bà	ʔ ɓ aː ˦˩
bài	ʔ ɓ aː j ˦˩
bàn	ʔ ɓ aː ŋ ˦˩
bàng	ʔ ɓ aː ŋ ˦˩
bành	ʔ ɓ ɛ ɲ ˦˩
bào	ʔ ɓ aː w ˦˩
bàu	ʔ ɓ a w ˦˩
bày	ʔ ɓ a j ˦˩
bá	ʔ ɓ aː ˨˩˦
bác	ʔ ɓ aː k̚ ˦˧˥
bách	ʔ ɓ a t̚ ˦˧˥
bám	ʔ ɓ aː m ˦˧˥
bán	ʔ ɓ aː ŋ ˦˧˥
báng	ʔ ɓ aː ŋ ˦˧˥
bánh	ʔ ɓ ɛ ɲ ˦˧˥
báo	ʔ ɓ aː w ˨˩˦
bát	ʔ ɓ aː k̚ ˦˧˥
báu	ʔ ɓ a w ˨˩˦
bâu	ʔ ɓ ə w ˧˧
bây	ʔ ɓ ə j ˧˧
bã	ʔ ɓ aː ˧˨
bãi	ʔ ɓ aː j ˧˨
bão	ʔ ɓ aː w ˧˨
bè	ʔ ɓ ɛ ˦˩
bèn	ʔ ɓ ɛ ŋ ˦˩
bèo	ʔ ɓ ɛ w ˦˩
bé	ʔ ɓ ɛ ˨˩˦
bén	ʔ ɓ ɛ ŋ ˦˧˥
béo	ʔ ɓ ɛ w ˨˩˦
bét	ʔ ɓ ɛ t̚ ˦˧˥
bê	ʔ ɓ e j ˧˧
bên	ʔ ɓ e n ˧˧
bênađô	ʔ ɓ e j ˧˧ n aː ˧˧ ʔ ɗ o w ˧˧
bênh	ʔ ɓ e n ˧˧
bênêđictô	ʔ ɓ e j ˧˧ n e j ˧˧ ʔ ɗ ɨ t̚ ˦˧˥ t o w ˧˧
bêu	ʔ ɓ e w ˧˧
bì	ʔ ɓ ɪ j ˦˩
bìa	ʔ ɓ i ə ˦˩
bình	ʔ ɓ ɨ n ˦˩
bìu	ʔ ɓ i w ˦˩
bí	ʔ ɓ ɪ j ˨˩˦
bích	ʔ ɓ ɨ t̚ ˦˧˥
bím	ʔ ɓ i m ˦˧˥
bính	ʔ ɓ ɨ n ˦˧˥
bíp	ʔ ɓ i p̚ ˦˧˥
bít	ʔ ɓ i t̚ ˦˧˥
bíu	ʔ ɓ i w ˨˩˦
bò	ʔ ɓ ɔ ˦˩
bòn	ʔ ɓ ɔ ŋ ˦˩
bó	ʔ ɓ ɔ ˨˩˦
bóc	ʔ ɓ a w k͡p̚ ˦˧˥
bói	ʔ ɓ ɔ j ˨˩˦
bón	ʔ ɓ ɔ ŋ ˦˧˥
bóng	ʔ ɓ a w ŋ͡m ˦˧˥
bóp	ʔ ɓ ɔ p̚ ˦˧˥
bót	ʔ ɓ ɔ k̚ ˦˧˥
bô	ʔ ɓ o w ˧˧
bôi	ʔ ɓ o j ˧˧
bôm	ʔ ɓ o m ˧˧
bông	ʔ ɓ ə w ŋ͡m ˧˧
bônifaciô	ʔ ɓ o ŋ ˧˧ n ɪ j ˧˧ f aː ˧˧ s ɪ j ˧˧ ʔ o w ˧˧
bõ	ʔ ɓ ɔ ˧˨
bù	ʔ ɓ ʊ w ˦˩
bùa	ʔ ɓ u ə ˦˩
bùi	ʔ ɓ u j ˦˩
bùm	ʔ ɓ u m ˦˩
bùn	ʔ ɓ u n ˦˩
bùng	ʔ ɓ ʊ w ŋ͡m ˦˩
bú	ʔ ɓ ʊ w ˨˩˦
búa	ʔ ɓ u ə ˨˩˦
búi	ʔ ɓ u j ˨˩˦
bún	ʔ ɓ u n ˦˧˥
búng	ʔ ɓ ʊ w ŋ͡m ˦˧˥
búp	ʔ ɓ u p̚ ˦˧˥
bút	ʔ ɓ ʊ k̚ ˦˧˥
băm	ʔ ɓ a m ˧˧
băng	ʔ ɓ a ŋ ˧˧
bĩ	ʔ ɓ ɪ j ˧˨
bĩu	ʔ ɓ i w ˧˨
bơ	ʔ ɓ əː ˧˧
bơi	ʔ ɓ əː j ˧˧
bơm	ʔ ɓ əː m ˧˧
bư	ʔ ɓ ɨ ˧˧
bưng	ʔ ɓ ɨ ŋ ˧˧
bưu	ʔ ɓ ɨ w ˧˧
bươi	ʔ ɓ ɨ j ˧˧
bươu	ʔ ɓ ɨ ə w ˧˧
bước	ʔ ɓ ɨ ə k̚ ˦˧˥
bướm	ʔ ɓ ɨ ə m ˦˧˥
bướng	ʔ ɓ ɨ ə ŋ ˦˧˥
bướu	ʔ ɓ ɨ ə w ˨˩˦
bưởi	ʔ ɓ ɨ j ˧˨
bạ	ʔ ɓ aː ˨˩ ʔ
bạc	ʔ ɓ aː k̚ ˨˩ ʔ
bạch	ʔ ɓ a t̚ ˨˩ ʔ
bại	ʔ ɓ aː j ˨˩ ʔ
bạn	ʔ ɓ aː ŋ ˨˩ ʔ
bạo	ʔ ɓ aː w ˨˩ ʔ
bạt	ʔ ɓ aː k̚ ˨˩ ʔ
bả	ʔ ɓ aː ˧˨
bản	ʔ ɓ aː ŋ ˧˨
bảng	ʔ ɓ aː ŋ ˧˨
bảo	ʔ ɓ aː w ˧˨
bảy	ʔ ɓ a j ˧˨
bấm	ʔ ɓ ə m ˦˧˥
bất	ʔ ɓ ə k̚ ˦˧˥
bấu	ʔ ɓ ə w ˨˩˦
bấy	ʔ ɓ ə j ˨˩˦
bầm	ʔ ɓ ə m ˦˩
bần	ʔ ɓ ə ŋ ˦˩
bầu	ʔ ɓ ə w ˦˩
bầy	ʔ ɓ ə j ˦˩
bẩm	ʔ ɓ ə m ˧˨
bẩn	ʔ ɓ ə ŋ ˧˨
bẩy	ʔ ɓ ə j ˧˨
bẫy	ʔ ɓ ə j ˧˨
bậc	ʔ ɓ ə k̚ ˨˩ ʔ
bận	ʔ ɓ ə ŋ ˨˩ ʔ
bật	ʔ ɓ ə k̚ ˨˩ ʔ
bậu	ʔ ɓ ə w ˨˩ ʔ
bậy	ʔ ɓ ə j ˨˩ ʔ
bắc	ʔ ɓ a k̚ ˦˧˥
bắn	ʔ ɓ a ŋ ˦˧˥
bắp	ʔ ɓ a p̚ ˦˧˥
bắt	ʔ ɓ a k̚ ˦˧˥
bằm	ʔ ɓ a m ˦˩
bằng	ʔ ɓ a ŋ ˦˩
bẹ	ʔ ɓ ɛ ˨˩ ʔ
bẹn	ʔ ɓ ɛ ŋ ˨˩ ʔ
bẹo	ʔ ɓ ɛ w ˨˩ ʔ
bẹp	ʔ ɓ ɛ p̚ ˨˩ ʔ
bẹt	ʔ ɓ ɛ t̚ ˨˩ ʔ
bẻ	ʔ ɓ ɛ ˧˨
bế	ʔ ɓ e j ˨˩˦
bến	ʔ ɓ e n ˦˧˥
bếp	ʔ ɓ e p̚ ˦˧˥
bết	ʔ ɓ e t̚ ˦˧˥
bề	ʔ ɓ e j ˦˩
bền	ʔ ɓ e n ˦˩
bể	ʔ ɓ e j ˧˨
bển	ʔ ɓ e n ˧˨
bệ	ʔ ɓ e j ˨˩ ʔ
bệch	ʔ ɓ e t̚ ˨˩ ʔ
bện	ʔ ɓ e n ˨˩ ʔ
bệnh	ʔ ɓ e n ˨˩ ʔ
bệt	ʔ ɓ e t̚ ˨˩ ʔ
bỉ	ʔ ɓ ɪ j ˧˨
bỉm	ʔ ɓ i m ˧˨
bị	ʔ ɓ ɪ j ˨˩ ʔ
bịa	ʔ ɓ i ə ˨˩ ʔ
bịch	ʔ ɓ ɨ t̚ ˨˩ ʔ
bịnh	ʔ ɓ ɨ n ˨˩ ʔ
bịp	ʔ ɓ i p̚ ˨˩ ʔ
bịt	ʔ ɓ i t̚ ˨˩ ʔ
bọ	ʔ ɓ ɔ ˨˩ ʔ
bọc	ʔ ɓ a w k͡p̚ ˨˩ ʔ
bọn	ʔ ɓ ɔ ŋ ˨˩ ʔ
bọng	ʔ ɓ a w ŋ͡m ˨˩ ʔ
bọt	ʔ ɓ ɔ k̚ ˨˩ ʔ
bỏ	ʔ ɓ ɔ ˧˨
bỏng	ʔ ɓ a w ŋ͡m ˧˨
bố	ʔ ɓ o w ˨˩˦
bốc	ʔ ɓ ə w k͡p̚ ˦˧˥
bốn	ʔ ɓ o ŋ ˦˧˥
bống	ʔ ɓ ə w ŋ͡m ˦˧˥
bốp	ʔ ɓ o p̚ ˦˧˥
bốt	ʔ ɓ o k̚ ˦˧˥
bồ	ʔ ɓ o w ˦˩
bồi	ʔ ɓ o j ˦˩
bồn	ʔ ɓ o ŋ ˦˩
bồng	ʔ ɓ ə w ŋ͡m ˦˩
bổ	ʔ ɓ o w ˧˨
bổi	ʔ ɓ o j ˧˨
bổn	ʔ ɓ o ŋ ˧˨
bổng	ʔ ɓ ə w ŋ͡m ˧˨
bỗng	ʔ ɓ ə w ŋ͡m ˧˨
bộ	ʔ ɓ o w ˨˩ ʔ
bội	ʔ ɓ o j ˨˩ ʔ
bộng	ʔ ɓ ə w ŋ͡m ˨˩ ʔ
bột	ʔ ɓ o k̚ ˨˩ ʔ
bớ	ʔ ɓ əː ˨˩˦
bới	ʔ ɓ əː j ˨˩˦
bớp	ʔ ɓ əː p̚ ˦˧˥
bớt	ʔ ɓ əː k̚ ˦˧˥
bờ	ʔ ɓ əː ˦˩
bờm	ʔ ɓ əː m ˦˩
bở	ʔ ɓ əː ˧˨
bởi	ʔ ɓ əː j ˧˨
bỡn	ʔ ɓ əː ŋ ˧˨
bợm	ʔ ɓ əː m ˨˩ ʔ
bụi	ʔ ɓ u j ˨˩ ʔ
bụm	ʔ ɓ u m ˨˩ ʔ
bụng	ʔ ɓ ʊ w ŋ͡m ˨˩ ʔ
bụt	ʔ ɓ ʊ k̚ ˨˩ ʔ
bủa	ʔ ɓ u ə ˧˨
bứa	ʔ ɓ ɨ ə ˨˩˦
bức	ʔ ɓ ɨ k̚ ˦˧˥
bứng	ʔ ɓ ɨ ŋ ˦˧˥
bứt	ʔ ɓ ɨ k̚ ˦˧˥
bừa	ʔ ɓ ɨ ə ˦˩
bừng	ʔ ɓ ɨ ŋ ˦˩
bửa	ʔ ɓ ɨ ə ˧˨
bữa	ʔ ɓ ɨ ə ˧˨
bự	ʔ ɓ ɨ ˨˩ ʔ
bựa	ʔ ɓ ɨ ə ˨˩ ʔ
bực	ʔ ɓ ɨ k̚ ˨˩ ʔ
c	s e j ˧˧
ca	k aː ˧˧
cacbon	k aː k̚ ˦˧˥ ʔ ɓ ɔ ŋ ˧˧
cai	k aː j ˧˧
califoni	k aː ˧˧ l ɪ j ˧˧ f ɔ ˧˧ n ɪ j ˧˧
cam	k aː m ˧˧
can	k aː ŋ ˧˧
canh	k ɛ ɲ ˧˧
canxi	k aː n ˧˧ s ɪ j ˧˧
cao	k aː w ˧˧
catarina	k aː ˧˧ t aː ˧˧ ʐ i n ˧˧ n aː ˧˧
cau	k a w ˧˧
cay	k a j ˧˧
cađimi	k aː ˧˧ ʔ ɗ ɪ j ˧˧ m ɪ j ˧˧
ch	s e j ˧˧ h aː k̚ ˦˧˥
cha	t͡ɕ aː ˧˧
chai	t͡ɕ aː j ˧˧
chanh	t͡ɕ ɛ ɲ ˧˧
chao	t͡ɕ aː w ˧˧
chau	t͡ɕ a w ˧˧
chay	t͡ɕ a j ˧˧
che	t͡ɕ ɛ ˧˧
chen	t͡ɕ ɛ ŋ ˧˧
cheo	t͡ɕ ɛ w ˧˧
chi	t͡ɕ ɪ j ˧˧
chia	t͡ɕ i ə ˧˧
chim	t͡ɕ i m ˧˧
chinh	t͡ɕ ɨ n ˧˧
chiêm	t͡ɕ i ə m ˧˧
chiên	t͡ɕ i ə ŋ ˧˧
chiêng	t͡ɕ i ə ŋ ˧˧
chiêu	t͡ɕ i w ˧˧
chiếc	t͡ɕ i ə k̚ ˦˧˥
chiếm	t͡ɕ i ə m ˦˧˥
chiến	t͡ɕ i ə ŋ ˦˧˥
chiếp	t͡ɕ i ə p̚ ˦˧˥
chiếu	t͡ɕ i w ˨˩˦
chiền	t͡ɕ i ə ŋ ˦˩
chiều	t͡ɕ i w ˦˩
cho	t͡ɕ ɔ ˧˧
choa	t͡ɕ w aː ˧˧
choáng	t͡ɕ w aː ŋ ˦˧˥
choãi	t͡ɕ w aː j ˧˨
choét	t͡ɕ w ɛ k̚ ˦˧˥
choắt	t͡ɕ w a k̚ ˦˧˥
chu	t͡ɕ ʊ w ˧˧
chua	t͡ɕ u ə ˧˧
chui	t͡ɕ u j ˧˧
chum	t͡ɕ u m ˧˧
chung	t͡ɕ ʊ w ŋ͡m ˧˧
chuyên	t͡ɕ w i ə ŋ ˧˧
chuyến	t͡ɕ w i ə ŋ ˦˧˥
chuyền	t͡ɕ w i ə ŋ ˦˩
chuyển	t͡ɕ w i ə ŋ ˧˨
chuyện	t͡ɕ w i ə ŋ ˨˩ ʔ
chuông	t͡ɕ u ə ŋ ˧˧
chuẩn	t͡ɕ w ə ŋ ˧˨
chuốc	t͡ɕ u ə k̚ ˦˧˥
chuối	t͡ɕ u j ˨˩˦
chuốt	t͡ɕ u ə k̚ ˦˧˥
chuồn	t͡ɕ u ə ŋ ˦˩
chuồng	t͡ɕ u ə ŋ ˦˩
chuỗi	t͡ɕ u j ˧˨
chuộc	t͡ɕ u ə k̚ ˨˩ ʔ
chuộng	t͡ɕ u ə ŋ ˨˩ ʔ
chuột	t͡ɕ u ə k̚ ˨˩ ʔ
chuỳ	t͡ɕ w ɪ j ˦˩
chxhcnvn	k ə w ŋ͡m ˨˩ ʔ h w aː ˦˩ s aː ˧˨ h o j ˨˩ ʔ t͡ɕ ʊ w ˧˨ ŋ i ə ˧˨ v i ə k̚ ˨˩ ʔ n aː m ˧˧
chà	t͡ɕ aː ˦˩
chài	t͡ɕ aː j ˦˩
chàm	t͡ɕ aː m ˦˩
chàng	t͡ɕ aː ŋ ˦˩
chào	t͡ɕ aː w ˦˩
chày	t͡ɕ a j ˦˩
chác	t͡ɕ aː k̚ ˦˧˥
chái	t͡ɕ aː j ˨˩˦
chán	t͡ɕ aː ŋ ˦˧˥
chánh	t͡ɕ ɛ ɲ ˦˧˥
cháo	t͡ɕ aː w ˨˩˦
chát	t͡ɕ aː k̚ ˦˧˥
cháu	t͡ɕ a w ˨˩˦
cháy	t͡ɕ a j ˨˩˦
châm	t͡ɕ ə m ˧˧
chân	t͡ɕ ə ŋ ˧˧
châu	t͡ɕ ə w ˧˧
chão	t͡ɕ aː w ˧˨
chè	t͡ɕ ɛ ˦˩
chèn	t͡ɕ ɛ ŋ ˦˩
chèo	t͡ɕ ɛ w ˦˩
ché	t͡ɕ ɛ ˨˩˦
chém	t͡ɕ ɛ m ˦˧˥
chén	t͡ɕ ɛ ŋ ˦˧˥
chéo	t͡ɕ ɛ w ˨˩˦
chép	t͡ɕ ɛ p̚ ˦˧˥
chê	t͡ɕ e j ˧˧
chêm	t͡ɕ e m ˧˧
chênh	t͡ɕ e n ˧˧
chì	t͡ɕ ɪ j ˦˩
chìa	t͡ɕ i ə ˦˩
chìm	t͡ɕ i m ˦˩
chí	t͡ɕ ɪ j ˨˩˦
chích	t͡ɕ ɨ t̚ ˦˧˥
chín	t͡ɕ i n ˦˧˥
chính	t͡ɕ ɨ n ˦˧˥
chíp	t͡ɕ i p̚ ˦˧˥
chít	t͡ɕ i t̚ ˦˧˥
chòi	t͡ɕ ɔ j ˦˩
chòm	t͡ɕ ɔ m ˦˩
chó	t͡ɕ ɔ ˨˩˦
chói	t͡ɕ ɔ j ˨˩˦
chóng	t͡ɕ a w ŋ͡m ˦˧˥
chóp	t͡ɕ ɔ p̚ ˦˧˥
chót	t͡ɕ ɔ k̚ ˦˧˥
chôm	t͡ɕ o m ˧˧
chôn	t͡ɕ o ŋ ˧˧
chông	t͡ɕ ə w ŋ͡m ˧˧
chõ	t͡ɕ ɔ ˧˨
chùa	t͡ɕ u ə ˦˩
chùi	t͡ɕ u j ˦˩
chùm	t͡ɕ u m ˦˩
chùn	t͡ɕ u n ˦˩
chú	t͡ɕ ʊ w ˨˩˦
chúa	t͡ɕ u ə ˨˩˦
chúc	t͡ɕ ʊ w k͡p̚ ˦˧˥
chúi	t͡ɕ u j ˨˩˦
chúng	t͡ɕ ʊ w ŋ͡m ˦˧˥
chút	t͡ɕ ʊ k̚ ˦˧˥
chăm	t͡ɕ a m ˧˧
chăn	t͡ɕ a ŋ ˧˧
chăng	t͡ɕ a ŋ ˧˧
chĩa	t͡ɕ i ə ˧˨
chơi	t͡ɕ əː j ˧˧
chưa	t͡ɕ ɨ ə ˧˧
chưng	t͡ɕ ɨ ŋ ˧˧
chương	t͡ɕ ɨ ə ŋ ˧˧
chước	t͡ɕ ɨ ə k̚ ˦˧˥
chướng	t͡ɕ ɨ ə ŋ ˦˧˥
chưởng	t͡ɕ ɨ ə ŋ ˧˨
chạc	t͡ɕ aː k̚ ˨˩ ʔ
chạm	t͡ɕ aː m ˨˩ ʔ
chạng	t͡ɕ aː ŋ ˨˩ ʔ
chạnh	t͡ɕ ɛ ɲ ˨˩ ʔ
chạo	t͡ɕ aː w ˨˩ ʔ
chạp	t͡ɕ aː p̚ ˨˩ ʔ
chạy	t͡ɕ a j ˨˩ ʔ
chả	t͡ɕ aː ˧˨
chải	t͡ɕ aː j ˧˨
chảnh	t͡ɕ ɛ ɲ ˧˨
chảo	t͡ɕ aː w ˧˨
chảy	t͡ɕ a j ˧˨
chấm	t͡ɕ ə m ˦˧˥
chấn	t͡ɕ ə ŋ ˦˧˥
chấp	t͡ɕ ə p̚ ˦˧˥
chất	t͡ɕ ə k̚ ˦˧˥
chấy	t͡ɕ ə j ˨˩˦
chầu	t͡ɕ ə w ˦˩
chậc	t͡ɕ ə k̚ ˨˩ ʔ
chậm	t͡ɕ ə m ˨˩ ʔ
chập	t͡ɕ ə p̚ ˨˩ ʔ
chật	t͡ɕ ə k̚ ˨˩ ʔ
chậu	t͡ɕ ə w ˨˩ ʔ
chắc	t͡ɕ a k̚ ˦˧˥
chắn	t͡ɕ a ŋ ˦˧˥
chắp	t͡ɕ a p̚ ˦˧˥
chắt	t͡ɕ a k̚ ˦˧˥
chằn	t͡ɕ a ŋ ˦˩
chằng	t͡ɕ a ŋ ˦˩
chẳng	t͡ɕ a ŋ ˧˨
chẵn	t͡ɕ a ŋ ˧˨
chặc	t͡ɕ a k̚ ˨˩ ʔ
chặn	t͡ɕ a ŋ ˨˩ ʔ
chặng	t͡ɕ a ŋ ˨˩ ʔ
chặt	t͡ɕ a k̚ ˨˩ ʔ
chẹt	t͡ɕ ɛ t̚ ˨˩ ʔ
chẻ	t͡ɕ ɛ ˧˨
chẽn	t͡ɕ ɛ ŋ ˧˨
chế	t͡ɕ e j ˨˩˦
chết	t͡ɕ e t̚ ˦˧˥
chệch	t͡ɕ e t̚ ˨˩ ʔ
chỉ	t͡ɕ ɪ j ˧˨
chỉnh	t͡ɕ ɨ n ˧˨
chị	t͡ɕ ɪ j ˨˩ ʔ
chịch	t͡ɕ ɨ t̚ ˨˩ ʔ
chịu	t͡ɕ i w ˨˩ ʔ
chọc	t͡ɕ a w k͡p̚ ˨˩ ʔ
chọi	t͡ɕ ɔ j ˨˩ ʔ
chọn	t͡ɕ ɔ ŋ ˨˩ ʔ
chọt	t͡ɕ ɔ k̚ ˨˩ ʔ
chỏm	t͡ɕ ɔ m ˧˨
chốc	t͡ɕ ə w k͡p̚ ˦˧˥
chối	t͡ɕ o j ˨˩˦
chốn	t͡ɕ o ŋ ˦˧˥
chống	t͡ɕ ə w ŋ͡m ˦˧˥
chốt	t͡ɕ o k̚ ˦˧˥
chồi	t͡ɕ o j ˦˩
chồm	t͡ɕ o m ˦˩
chồn	t͡ɕ o ŋ ˦˩
chồng	t͡ɕ ə w ŋ͡m ˦˩
chổi	t͡ɕ o j ˧˨
chỗ	t͡ɕ o w ˧˨
chộ	t͡ɕ o w ˨˩ ʔ
chộp	t͡ɕ o p̚ ˨˩ ʔ
chột	t͡ɕ o k̚ ˨˩ ʔ
chớ	t͡ɕ əː ˨˩˦
chớm	t͡ɕ əː m ˦˧˥
chớp	t͡ɕ əː p̚ ˦˧˥
chờ	t͡ɕ əː ˦˩
chở	t͡ɕ əː ˧˨
chợ	t͡ɕ əː ˨˩ ʔ
chợp	t͡ɕ əː p̚ ˨˩ ʔ
chợt	t͡ɕ əː k̚ ˨˩ ʔ
chục	t͡ɕ ʊ w k͡p̚ ˨˩ ʔ
chụm	t͡ɕ u m ˨˩ ʔ
chụp	t͡ɕ u p̚ ˨˩ ʔ
chụt	t͡ɕ ʊ k̚ ˨˩ ʔ
chủ	t͡ɕ ʊ w ˧˨
chủng	t͡ɕ ʊ w ŋ͡m ˧˨
chứ	t͡ɕ ɨ ˨˩˦
chứa	t͡ɕ ɨ ə ˨˩˦
chức	t͡ɕ ɨ k̚ ˦˧˥
chứng	t͡ɕ ɨ ŋ ˦˧˥
chứt	t͡ɕ ɨ k̚ ˦˧˥
chừ	t͡ɕ ɨ ˦˩
chừa	t͡ɕ ɨ ə ˦˩
chừng	t͡ɕ ɨ ŋ ˦˩
chử	t͡ɕ ɨ ˧˨
chửa	t͡ɕ ɨ ə ˧˨
chửi	t͡ɕ ɨ j ˧˨
chữ	t͡ɕ ɨ ˧˨
chữa	t͡ɕ ɨ ə ˧˨
chực	t͡ɕ ɨ k̚ ˨˩ ʔ
clb	k ə w ˧˧ l aː k̚ ˨˩ ʔ ʔ ɓ o w ˨˩ ʔ
clo	k l ɔ ˧˧
clêmêntê	k l e j ˧˧ m e n ˧˧ t e j ˧˧
co	k ɔ ˧˧
coban	k o w ˧˧ ʔ ɓ aː n ˧˧
cocktail	k o k̚ ˦˧˥ t a j ˧˧
coi	k ɔ j ˧˧
con	k ɔ ŋ ˧˧
cong	k a w ŋ͡m ˧˧
constantinô	k ɔ ŋ ˧˧ s t aː ŋ ˧˧ t i n ˧˧ n o w ˧˧
coronavirus	k ɔ ˧˧ ʐ o w ˧˧ n aː ˧˧ v ɪ j ˧˧ ɹ ʊ k̚ ˦˧˥
cpcmltchmnvn	t͡ɕ ɨ n ˦˧˥ f ʊ w ˧˨ k a t̚ ˦˧˥ m aː ŋ ˨˩ ʔ l ə m ˧˧ tʰ əː j ˦˩ k ə w ŋ͡m ˨˩ ʔ h w aː ˦˩ m i ə ŋ ˦˩ n aː m ˧˧ v i ə k̚ ˨˩ ʔ n aː m ˧˧
crom	k ɹ o m ˧˧
crôkê	k ɹ o w ˧˧ k e j ˧˧
csdl	k əː ˧˧ ʂ əː ˧˨ j ɨ ˧˨ l i w ˨˩ ʔ
cttđvn	k aː k̚ ˦˧˥ tʰ ɛ ɲ ˦˧˥ t ɨ ˧˨ ʔ ɗ aː w ˨˩ ʔ v i ə k̚ ˨˩ ʔ n aː m ˧˧
cu	k ʊ w ˧˧
cua	k u ə ˧˧
cumingtonit	k əː ˧˧ m ɨ n ˧˧ t o w ˧˧ n i t̚ ˦˧˥
cung	k ʊ w ŋ͡m ˧˧
curi	k ʊ w ˧˧ ɹ ɪ j ˧˧
cuốc	k u ə k̚ ˦˧˥
cuối	k u j ˨˩˦
cuốn	k u ə ŋ ˦˧˥
cuống	k u ə ŋ ˦˧˥
cuồng	k u ə ŋ ˦˩
cuộc	k u ə k̚ ˨˩ ʔ
cuội	k u j ˨˩ ʔ
cuộn	k u ə ŋ ˨˩ ʔ
cà	k aː ˦˩
cài	k aː j ˦˩
càn	k aː ŋ ˦˩
càng	k aː ŋ ˦˩
cành	k ɛ ɲ ˦˩
cào	k aː w ˦˩
cày	k a j ˦˩
cá	k aː ˨˩˦
các	k aː k̚ ˦˧˥
cách	k a t̚ ˦˧˥
cái	k aː j ˨˩˦
cám	k aː m ˦˧˥
cán	k aː ŋ ˦˧˥
cáng	k aː ŋ ˦˧˥
cánh	k ɛ ɲ ˦˧˥
cáo	k aː w ˨˩˦
cáp	k aː p̚ ˦˧˥
cát	k aː k̚ ˦˧˥
cáu	k a w ˨˩˦
cáy	k a j ˨˩˦
câm	k ə m ˧˧
cân	k ə ŋ ˧˧
câng	k ə ŋ ˧˧
câu	k ə w ˧˧
cây	k ə j ˧˧
cãi	k aː j ˧˨
cò	k ɔ ˦˩
còi	k ɔ j ˦˩
còm	k ɔ m ˦˩
còn	k ɔ ŋ ˦˩
còng	k a w ŋ͡m ˦˩
có	k ɔ ˨˩˦
cóc	k a w k͡p̚ ˦˧˥
cói	k ɔ j ˨˩˦
cóng	k a w ŋ͡m ˦˧˥
cót	k ɔ k̚ ˦˧˥
cô	k o w ˧˧
côi	k o j ˧˧
côn	k o ŋ ˧˧
công	k ə w ŋ͡m ˧˧
côngxoocxiom	k ə w ŋ͡m ˧˧ s ɔ k̚ ˦˧˥ s ɪ j ˧˧ ʔ ɔ m ˧˧
côrnêliô	k o w ˧˧ n e j ˧˧ l ɪ j ˧˧ ʔ o w ˧˧
côsin	k o w ˧˧ ʂ i n ˧˧
côtang	k o w ˧˧ t aː ŋ ˧˧
cõi	k ɔ j ˧˨
cõng	k a w ŋ͡m ˧˨
cù	k ʊ w ˦˩
cùi	k u j ˦˩
cùm	k u m ˦˩
cùn	k u n ˦˩
cùng	k ʊ w ŋ͡m ˦˩
cú	k ʊ w ˨˩˦
cúc	k ʊ w k͡p̚ ˦˧˥
cúi	k u j ˨˩˦
cúm	k u m ˦˧˥
cún	k u n ˦˧˥
cúng	k ʊ w ŋ͡m ˦˧˥
cúp	k u p̚ ˦˧˥
cút	k ʊ k̚ ˦˧˥
căm	k a m ˧˧
căn	k a ŋ ˧˧
căng	k a ŋ ˧˧
cđ	k aː w ˧˧ ʔ ɗ a ŋ ˧˨
cđ	k ə w ŋ͡m ˨˩ ʔ ʔ ɗ ə w ŋ͡m ˦˩
cũ	k ʊ w ˧˨
cũi	k u j ˧˨
cũng	k ʊ w ŋ͡m ˧˨
cơ	k əː ˧˧
cơi	k əː j ˧˧
cơm	k əː m ˧˧
cơn	k əː ŋ ˧˧
cư	k ɨ ˧˧
cưa	k ɨ ə ˧˧
cưng	k ɨ ŋ ˧˧
cươi	k ɨ j ˧˧
cương	k ɨ ə ŋ ˧˧
cước	k ɨ ə k̚ ˦˧˥
cưới	k ɨ j ˨˩˦
cướp	k ɨ ə p̚ ˦˧˥
cười	k ɨ j ˦˩
cườm	k ɨ ə m ˦˩
cường	k ɨ ə ŋ ˦˩
cưỡi	k ɨ j ˧˨
cưỡng	k ɨ ə ŋ ˧˨
cược	k ɨ ə k̚ ˨˩ ʔ
cạ	k aː ˨˩ ʔ
cạc	k aː k̚ ˨˩ ʔ
cạch	k a t̚ ˨˩ ʔ
cạm	k aː m ˨˩ ʔ
cạn	k aː ŋ ˨˩ ʔ
cạnh	k ɛ ɲ ˨˩ ʔ
cạo	k aː w ˨˩ ʔ
cạp	k aː p̚ ˨˩ ʔ
cạy	k a j ˨˩ ʔ
cả	k aː ˧˨
cải	k aː j ˧˨
cảm	k aː m ˧˨
cản	k aː ŋ ˧˨
cảng	k aː ŋ ˧˨
cảnh	k ɛ ɲ ˧˨
cấm	k ə m ˦˧˥
cấp	k ə p̚ ˦˧˥
cất	k ə k̚ ˦˧˥
cấu	k ə w ˨˩˦
cấy	k ə j ˨˩˦
cầm	k ə m ˦˩
cần	k ə ŋ ˦˩
cầu	k ə w ˦˩
cầy	k ə j ˦˩
cẩm	k ə m ˧˨
cẩu	k ə w ˧˨
cận	k ə ŋ ˨˩ ʔ
cật	k ə k̚ ˨˩ ʔ
cậu	k ə w ˨˩ ʔ
cậy	k ə j ˨˩ ʔ
cắc	k a k̚ ˦˧˥
cắm	k a m ˦˧˥
cắn	k a ŋ ˦˧˥
cắp	k a p̚ ˦˧˥
cắt	k a k̚ ˦˧˥
cằm	k a m ˦˩
cẳng	k a ŋ ˧˨
cặc	k a k̚ ˨˩ ʔ
cặn	k a ŋ ˨˩ ʔ
cặp	k a p̚ ˨˩ ʔ
cọ	k ɔ ˨˩ ʔ
cọc	k a w k͡p̚ ˨˩ ʔ
cọng	k a w ŋ͡m ˨˩ ʔ
cọp	k ɔ p̚ ˨˩ ʔ
cỏ	k ɔ ˧˨
cố	k o w ˨˩˦
cốc	k ə w k͡p̚ ˦˧˥
cối	k o j ˨˩˦
cốm	k o m ˦˧˥
cống	k ə w ŋ͡m ˦˧˥
cốp	k o p̚ ˦˧˥
cốt	k o k̚ ˦˧˥
cồn	k o ŋ ˦˩
cồng	k ə w ŋ͡m ˦˩
cổ	k o w ˧˨
cổng	k ə w ŋ͡m ˧˨
cỗ	k o w ˧˨
cỗi	k o j ˧˨
cộ	k o w ˨˩ ʔ
cội	k o j ˨˩ ʔ
cộm	k o m ˨˩ ʔ
cộng	k ə w ŋ͡m ˨˩ ʔ
cột	k o k̚ ˨˩ ʔ
cớ	k əː ˨˩˦
cớm	k əː m ˦˧˥
cờ	k əː ˦˩
cởi	k əː j ˧˨
cỡ	k əː ˧˨
cỡi	k əː j ˧˨
cụ	k ʊ w ˨˩ ʔ
cục	k ʊ w k͡p̚ ˨˩ ʔ
cụm	k u m ˨˩ ʔ
cụng	k ʊ w ŋ͡m ˨˩ ʔ
cụp	k u p̚ ˨˩ ʔ
cụt	k ʊ k̚ ˨˩ ʔ
củ	k ʊ w ˧˨
của	k u ə ˧˨
củi	k u j ˧˨
cứ	k ɨ ˨˩˦
cứa	k ɨ ə ˨˩˦
cứng	k ɨ ŋ ˦˧˥
cứt	k ɨ k̚ ˦˧˥
cứu	k ɨ w ˨˩˦
cừu	k ɨ w ˦˩
cử	k ɨ ˧˨
cửa	k ɨ ə ˧˨
cửi	k ɨ j ˧˨
cửu	k ɨ w ˧˨
cự	k ɨ ˨˩ ʔ
cựa	k ɨ ə ˨˩ ʔ
cực	k ɨ k̚ ˨˩ ʔ
cựu	k ɨ w ˨˩ ʔ
d	j e j ˧˧
da	j aː ˧˧
dai	j aː j ˧˧
dam	j aː m ˧˧
dang	j aː ŋ ˧˧
danh	j ɛ ɲ ˧˧
dao	j aː w ˧˧
decimet	ʔ ɗ e j ˧˧ s ɪ j ˧˧ m ɛ t̚ ˦˧˥
dinh	j ɨ n ˧˧
diêm	j i ə m ˧˧
diếp	j i ə p̚ ˦˧˥
diều	j i w ˦˩
diễn	j i ə ŋ ˧˨
diệc	j i ə k̚ ˨˩ ʔ
diện	j i ə ŋ ˨˩ ʔ
diệp	j i ə p̚ ˨˩ ʔ
diệt	j i ə k̚ ˨˩ ʔ
diệu	j i w ˨˩ ʔ
do	j ɔ ˧˧
dom	j ɔ m ˧˧
don	j ɔ ŋ ˧˧
dong	j a w ŋ͡m ˧˧
doạ	j w aː ˨˩ ʔ
du	j ʊ w ˧˧
dung	j ʊ w ŋ͡m ˧˧
duy	j w ɪ j ˧˧
duyên	j w i ə ŋ ˧˧
duyệt	j w i ə k̚ ˨˩ ʔ
duối	j u j ˨˩˦
duỗi	j u j ˧˨
dzô	j o w ˧˧
dài	j aː j ˦˩
dàn	j aː ŋ ˦˩
dành	j ɛ ɲ ˦˩
dày	j a j ˦˩
dái	j aː j ˨˩˦
dám	j aː m ˦˧˥
dán	j aː ŋ ˦˧˥
dáng	j aː ŋ ˦˧˥
dâm	j ə m ˧˧
dân	j ə ŋ ˧˧
dâng	j ə ŋ ˧˧
dâu	j ə w ˧˧
dây	j ə j ˧˧
dã	j aː ˧˨
dãi	j aː j ˧˨
dãn	j aː ŋ ˧˨
dãy	j a j ˧˨
dè	j ɛ ˦˩
dép	j ɛ p̚ ˦˧˥
dét	j ɛ t̚ ˦˧˥
dê	j e j ˧˧
dì	j ɪ j ˦˩
dìm	j i m ˦˩
dìu	j i w ˦˩
dí	j ɪ j ˨˩˦
dím	j i m ˦˧˥
dính	j ɨ n ˦˧˥
dò	j ɔ ˦˩
dòm	j ɔ m ˦˩
dòng	j a w ŋ͡m ˦˩
dóc	j a w k͡p̚ ˦˧˥
dóm	j ɔ m ˦˧˥
dô	j o w ˧˧
dông	j ə w ŋ͡m ˧˧
dõi	j ɔ j ˧˨
dù	j ʊ w ˦˩
dùi	j u j ˦˩
dùm	j u m ˦˩
dùng	j ʊ w ŋ͡m ˦˩
dúi	j u j ˨˩˦
dúm	j u m ˦˧˥
dăm	j a m ˧˧
dĩ	j ɪ j ˧˨
dĩa	j i ə ˧˨
dũng	j ʊ w ŋ͡m ˧˨
dơ	j əː ˧˧
dơi	j əː j ˧˧
dư	j ɨ ˧˧
dưa	j ɨ ə ˧˧
dưng	j ɨ ŋ ˧˧
dương	j ɨ ə ŋ ˧˧
dưới	j ɨ j ˨˩˦
dường	j ɨ ə ŋ ˦˩
dưỡng	j ɨ ə ŋ ˧˨
dược	j ɨ ə k̚ ˨˩ ʔ
dượng	j ɨ ə ŋ ˨˩ ʔ
dượt	j ɨ ə k̚ ˨˩ ʔ
dạ	j aː ˨˩ ʔ
dại	j aː j ˨˩ ʔ
dạn	j aː ŋ ˨˩ ʔ
dạng	j aː ŋ ˨˩ ʔ
dạo	j aː w ˨˩ ʔ
dạy	j a j ˨˩ ʔ
dải	j aː j ˧˨
dấn	j ə ŋ ˦˧˥
dấu	j ə w ˨˩˦
dấy	j ə j ˨˩˦
dầm	j ə m ˦˩
dần	j ə ŋ ˦˩
dầu	j ə w ˦˩
dẫn	j ə ŋ ˧˨
dẫu	j ə w ˧˨
dậm	j ə m ˨˩ ʔ
dập	j ə p̚ ˨˩ ʔ
dậu	j ə w ˨˩ ʔ
dậy	j ə j ˨˩ ʔ
dắt	j a k̚ ˦˧˥
dằm	j a m ˦˩
dằn	j a ŋ ˦˩
dặm	j a m ˨˩ ʔ
dặn	j a ŋ ˨˩ ʔ
dẹp	j ɛ p̚ ˨˩ ʔ
dẹt	j ɛ t̚ ˨˩ ʔ
dẻ	j ɛ ˧˨
dẻo	j ɛ w ˧˨
dẽ	j ɛ ˧˨
dế	j e j ˨˩˦
dền	j e n ˦˩
dễ	j e j ˧˨
dệt	j e t̚ ˨˩ ʔ
dịch	j ɨ t̚ ˨˩ ʔ
dịp	j i p̚ ˨˩ ʔ
dịu	j i w ˨˩ ʔ
dọc	j a w k͡p̚ ˨˩ ʔ
dọn	j ɔ ŋ ˨˩ ʔ
dỏ	j ɔ ˧˨
dỏm	j ɔ m ˧˨
dốc	j ə w k͡p̚ ˦˧˥
dối	j o j ˨˩˦
dốt	j o k̚ ˦˧˥
dồi	j o j ˦˩
dồn	j o ŋ ˦˩
dỗ	j o w ˧˨
dỗi	j o j ˧˨
dộc	j ə w k͡p̚ ˨˩ ʔ
dội	j o j ˨˩ ʔ
dộng	j ə w ŋ͡m ˨˩ ʔ
dột	j o k̚ ˨˩ ʔ
dớp	j əː p̚ ˦˧˥
dớt	j əː k̚ ˦˧˥
dời	j əː j ˦˩
dở	j əː ˧˨
dởm	j əː m ˧˨
dỡ	j əː ˧˨
dợm	j əː m ˨˩ ʔ
dụ	j ʊ w ˨˩ ʔ
dục	j ʊ w k͡p̚ ˨˩ ʔ
dụng	j ʊ w ŋ͡m ˨˩ ʔ
dứa	j ɨ ə ˨˩˦
dức	j ɨ k̚ ˦˧˥
dứt	j ɨ k̚ ˦˧˥
dừa	j ɨ ə ˦˩
dừng	j ɨ ŋ ˦˩
dử	j ɨ ˧˨
dửng	j ɨ ŋ ˧˨
dữ	j ɨ ˧˨
dự	j ɨ ˨˩ ʔ
dựa	j ɨ ə ˨˩ ʔ
dựng	j ɨ ŋ ˨˩ ʔ
e	ʔ ɛ ˧˧
electron	ʔ ɛ ˧˧ l ɛ k̚ ˦˧˥ ʈ ə w ŋ͡m ˧˧
elip	ʔ ɛ ˧˧ l i p̚ ˦˧˥
em	ʔ ɛ m ˧˧
ensteni	ʔ ɛ ŋ ˧˧ s t ɛ ˧˧ n ɪ j ˧˧
eo	ʔ ɛ w ˧˧
eribi	ʔ ɛ ˧˧ ɹ ɪ j ˧˧ ʔ ɓ ɪ j ˧˧
eu	ʔ ɛ ˧˧ ʔ ʊ w ˧˧
europi	ʔ e w ˧˧ ɹ o w ˧˧ p ɪ j ˧˧
fa	ʔ ɛ p̚ ˦˧˥ f əː ˦˩ ʔ aː ˧˧
fara	f aː ˧˧ ʐ aː ˧˧
fecmi	f ɛ k̚ ˦˧˥ m ɪ j ˧˧
flerovi	f l e j ˧˧ ɹ ɔ ˧˧ v ɪ j ˧˧
flo	f l ɔ ˧˧
franxi	f ɹ aː ŋ ˧˧ s ɪ j ˧˧
fêlix	f e j ˧˧ l ɨ t̚ ˦˧˥
g	j e j ˧˧
g	ɣ əː ˦˩
ga	ɣ aː ˧˧
gai	ɣ aː j ˧˧
gali	ɣ aː ˧˧ l ɪ j ˧˧
gam	ɣ aː m ˧˧
gan	ɣ aː ŋ ˧˧
gang	ɣ aː ŋ ˧˧
ganh	ɣ ɛ ɲ ˧˧
gato	ɣ aː ˧˧ t ɔ ˧˧
gay	ɣ a j ˧˧
gađolini	ɣ aː ˧˧ ʔ ɗ o w ˧˧ l ɪ j ˧˧ n ɪ j ˧˧
gemani	j ɛ ˧˧ m aː ˧˧ n ɪ j ˧˧
gen	j ɛ ŋ ˧˧
ghe	ɣ ɛ ˧˧
ghen	ɣ ɛ ŋ ˧˧
ghi	ɣ ɪ j ˧˧
ghim	ɣ i m ˧˧
ghiền	ɣ i ə ŋ ˦˩
ghè	ɣ ɛ ˦˩
ghèn	ɣ ɛ ŋ ˦˩
ghé	ɣ ɛ ˨˩˦
ghép	ɣ ɛ p̚ ˦˧˥
ghét	ɣ ɛ t̚ ˦˧˥
ghê	ɣ e j ˧˧
ghì	ɣ ɪ j ˦˩
ghìm	ɣ i m ˦˩
ghẹ	ɣ ɛ ˨˩ ʔ
ghẹo	ɣ ɛ w ˨˩ ʔ
ghẻ	ɣ ɛ ˧˨
ghế	ɣ e j ˨˩˦
ghệ	ɣ e j ˨˩ ʔ
ghệt	ɣ e t̚ ˨˩ ʔ
gi	j ɪ j ˧˧
gia	j aː ˧˧
giacôbê	j aː ˧˧ k o w ˧˧ ʔ ɓ e j ˧˧
giai	j aː j ˧˧
giam	j aː m ˧˧
gian	j aː ŋ ˧˧
giang	j aː ŋ ˧˧
giao	j aː w ˧˧
gieo	j ɛ w ˧˧
gio	j ɔ ˧˧
gioan	j w aː ŋ ˧˧
giong	j a w ŋ͡m ˧˧
giuliô	j ʊ w ˧˧ l ɪ j ˧˧ ʔ o w ˧˧
giun	j u n ˧˧
giuse	j ʊ w ˧˧ ʂ ɛ ˧˧
giuđa	j ʊ w ˧˧ ʔ ɗ aː ˧˧
giuộc	j u ə k̚ ˨˩ ʔ
già	j aː ˦˩
giàn	j aː ŋ ˦˩
giàng	j aː ŋ ˦˩
giành	j ɛ ɲ ˦˩
giàu	j a w ˦˩
giày	j a j ˦˩
giá	j aː ˨˩˦
giác	j aː k̚ ˦˧˥
gián	j aː ŋ ˦˧˥
giáng	j aː ŋ ˦˧˥
giáo	j aː w ˨˩˦
giáp	j aː p̚ ˦˧˥
giáy	j a j ˨˩˦
giâm	j ə m ˧˧
giây	j ə j ˧˧
giã	j aː ˧˨
giãi	j aː j ˧˨
giãn	j aː ŋ ˧˨
giãy	j a j ˧˨
gié	j ɛ ˨˩˦
giê	j e j ˧˧
giêng	j i ə ŋ ˧˧
giêsu	j e j ˧˧ ʂ ʊ w ˧˧
giò	j ɔ ˦˩
giòi	j ɔ j ˦˩
giòn	j ɔ ŋ ˦˩
gió	j ɔ ˨˩˦
gióc	j a w k͡p̚ ˦˧˥
gióng	j a w ŋ͡m ˦˧˥
giông	j ə w ŋ͡m ˧˧
giùi	j u j ˦˩
giùm	j u m ˦˩
giú	j ʊ w ˨˩˦
giúp	j u p̚ ˦˧˥
giăm	j a m ˧˧
giăng	j a ŋ ˧˧
giũ	j ʊ w ˧˨
giũa	j u ə ˧˨
giơ	j əː ˧˧
giương	j ɨ ə ŋ ˧˧
giường	j ɨ ə ŋ ˦˩
giạng	j aː ŋ ˨˩ ʔ
giạt	j aː k̚ ˨˩ ʔ
giả	j aː ˧˨
giải	j aː j ˧˨
giảm	j aː m ˧˨
giảng	j aː ŋ ˧˨
giảnh	j ɛ ɲ ˧˨
giảo	j aː w ˧˨
giấc	j ə k̚ ˦˧˥
giấm	j ə m ˦˧˥
giấu	j ə w ˨˩˦
giấy	j ə j ˨˩˦
giầm	j ə m ˦˩
giầu	j ə w ˦˩
giầy	j ə j ˦˩
giẫm	j ə m ˧˨
giậm	j ə m ˨˩ ʔ
giận	j ə ŋ ˨˩ ʔ
giập	j ə p̚ ˨˩ ʔ
giật	j ə k̚ ˨˩ ʔ
giậu	j ə w ˨˩ ʔ
giằm	j a m ˦˩
giặc	j a k̚ ˨˩ ʔ
giặt	j a k̚ ˨˩ ʔ
giẹp	j ɛ p̚ ˨˩ ʔ
giẻ	j ɛ ˧˨
giếm	j i ə m ˦˧˥
giếng	j i ə ŋ ˦˧˥
giết	j i ə k̚ ˦˧˥
giền	j e n ˦˩
giềng	j i ə ŋ ˦˩
giễu	j i w ˧˨
giọi	j ɔ j ˨˩ ʔ
giọng	j a w ŋ͡m ˨˩ ʔ
giọt	j ɔ k̚ ˨˩ ʔ
giỏ	j ɔ ˧˨
giỏi	j ɔ j ˧˨
giống	j ə w ŋ͡m ˦˧˥
giồng	j ə w ŋ͡m ˦˩
giỗ	j o w ˧˨
giội	j o j ˨˩ ʔ
giới	j əː j ˨˩˦
giờ	j əː ˦˩
giời	j əː j ˦˩
giở	j əː ˧˨
giỡn	j əː ŋ ˧˨
giục	j ʊ w k͡p̚ ˨˩ ʔ
giụi	j u j ˨˩ ʔ
giừ	j ɨ ˦˩
giữ	j ɨ ˧˨
giữa	j ɨ ə ˧˨
giựt	j ɨ k̚ ˨˩ ʔ
go	ɣ ɔ ˧˧
golf	ɣ o ŋ ˧˧
gom	ɣ ɔ m ˧˧
goá	ɣ w aː ˨˩˦
grêgôriô	ʐ e j ˧˧ ɣ o w ˧˧ ʐ ɪ j ˧˧ ʔ o w ˧˧
gu	ɣ ʊ w ˧˧
guốc	ɣ u ə k̚ ˦˧˥
guồng	ɣ u ə ŋ ˦˩
gà	ɣ aː ˦˩
gài	ɣ aː j ˦˩
gàn	ɣ aː ŋ ˦˩
gào	ɣ aː w ˦˩
gàu	ɣ a w ˦˩
gác	ɣ aː k̚ ˦˧˥
gái	ɣ aː j ˨˩˦
gán	ɣ aː ŋ ˦˧˥
gánh	ɣ ɛ ɲ ˦˧˥
gáo	ɣ aː w ˨˩˦
gáy	ɣ a j ˨˩˦
gân	ɣ ə ŋ ˧˧
gâu	ɣ ə w ˧˧
gây	ɣ ə j ˧˧
gã	ɣ aː ˧˨
gãi	ɣ aː j ˧˨
gãy	ɣ a j ˧˨
gì	j ɪ j ˦˩
gìn	j i n ˦˩
gò	ɣ ɔ ˦˩
góc	ɣ a w k͡p̚ ˦˧˥
gói	ɣ ɔ j ˨˩˦
góp	ɣ ɔ p̚ ˦˧˥
gót	ɣ ɔ k̚ ˦˧˥
gôm	ɣ o m ˧˧
gôn	ɣ o ŋ ˧˧
gông	ɣ ə w ŋ͡m ˧˧
gõ	ɣ ɔ ˧˨
gù	ɣ ʊ w ˦˩
gùi	ɣ u j ˦˩
gút	ɣ ʊ k̚ ˦˧˥
găm	ɣ a m ˧˧
găng	ɣ a ŋ ˧˧
gươm	ɣ ɨ ə m ˧˧
gương	ɣ ɨ ə ŋ ˧˧
gượm	ɣ ɨ ə m ˨˩ ʔ
gượng	ɣ ɨ ə ŋ ˨˩ ʔ
gạ	ɣ aː ˨˩ ʔ
gạc	ɣ aː k̚ ˨˩ ʔ
gạch	ɣ a t̚ ˨˩ ʔ
gạo	ɣ aː w ˨˩ ʔ
gạt	ɣ aː k̚ ˨˩ ʔ
gả	ɣ aː ˧˨
gảy	ɣ a j ˧˨
gấc	ɣ ə k̚ ˦˧˥
gấm	ɣ ə m ˦˧˥
gấp	ɣ ə p̚ ˦˧˥
gấu	ɣ ə w ˨˩˦
gấy	ɣ ə j ˨˩˦
gầm	ɣ ə m ˦˩
gần	ɣ ə ŋ ˦˩
gầy	ɣ ə j ˦˩
gẫm	ɣ ə m ˧˨
gập	ɣ ə p̚ ˨˩ ʔ
gật	ɣ ə k̚ ˨˩ ʔ
gậy	ɣ ə j ˨˩ ʔ
gắn	ɣ a ŋ ˦˧˥
gắng	ɣ a ŋ ˦˧˥
gắp	ɣ a p̚ ˦˧˥
gắt	ɣ a k̚ ˦˧˥
gằn	ɣ a ŋ ˦˩
gặm	ɣ a m ˨˩ ʔ
gặng	ɣ a ŋ ˨˩ ʔ
gặp	ɣ a p̚ ˨˩ ʔ
gặt	ɣ a k̚ ˨˩ ʔ
gọi	ɣ ɔ j ˨˩ ʔ
gọn	ɣ ɔ ŋ ˨˩ ʔ
gọng	ɣ a w ŋ͡m ˨˩ ʔ
gọt	ɣ ɔ k̚ ˨˩ ʔ
gỏi	ɣ ɔ j ˧˨
gốc	ɣ ə w k͡p̚ ˦˧˥
gối	ɣ o j ˨˩˦
gốm	ɣ o m ˦˧˥
gồm	ɣ o m ˦˩
gồng	ɣ ə w ŋ͡m ˦˩
gỗ	ɣ o w ˧˨
gộc	ɣ ə w k͡p̚ ˨˩ ʔ
gội	ɣ o j ˨˩ ʔ
gộp	ɣ o p̚ ˨˩ ʔ
gớm	ɣ əː m ˦˧˥
gờ	ɣ əː ˦˩
gờm	ɣ əː m ˦˩
gở	ɣ əː ˧˨
gởi	ɣ əː j ˧˨
gỡ	ɣ əː ˧˨
gợi	ɣ əː j ˨˩ ʔ
gợn	ɣ əː ŋ ˨˩ ʔ
gục	ɣ ʊ w k͡p̚ ˨˩ ʔ
gừng	ɣ ɨ ŋ ˦˩
gửi	ɣ ɨ j ˧˨
h	h a k̚ ˦˧˥
h'mông	h əː ˦˩ m ə w ŋ͡m ˧˧
ha	h aː ˧˧
hafini	h aː ˧˧ f ɪ j ˧˧ n ɪ j ˧˧
hai	h aː j ˧˧
ham	h aː m ˧˧
hang	h aː ŋ ˧˧
hao	h aː w ˧˧
hay	h a j ˧˧
heli	h e j ˧˧ l ɪ j ˧˧
hen	h ɛ ŋ ˧˧
heo	h ɛ w ˧˧
hi	h ɪ j ˧˧
hia	h i ə ˧˧
hic	h ɨ t̚ ˦˧˥
hilariô	h ɪ j ˧˧ l aː ˧˧ ʐ ɪ j ˧˧ ʔ o w ˧˧
hiu	h i w ˧˧
hiên	h i ə ŋ ˧˧
hiđro	h ɪ j ˧˧ ʔ ɗ ɹ o w ˧˧
hiếm	h i ə m ˦˧˥
hiến	h i ə ŋ ˦˧˥
hiếp	h i ə p̚ ˦˧˥
hiếu	h i w ˨˩˦
hiền	h i ə ŋ ˦˩
hiểm	h i ə m ˧˨
hiển	h i ə ŋ ˧˨
hiểu	h i w ˧˨
hiện	h i ə ŋ ˨˩ ʔ
hiệp	h i ə p̚ ˨˩ ʔ
hiệu	h i w ˨˩ ʔ
ho	h ɔ ˧˧
hoa	h w aː ˧˧
hoang	h w aː ŋ ˧˧
hoen	h w ɛ ŋ ˧˧
hoi	h ɔ j ˧˧
hong	h a w ŋ͡m ˧˧
honmi	h o n ˧˧ m ɪ j ˧˧
hoà	h w aː ˦˩
hoài	h w aː j ˦˩
hoàn	h w aː ŋ ˦˩
hoàng	h w aː ŋ ˦˩
hoá	h w aː ˨˩˦
hoãn	h w aː ŋ ˧˨
hoè	h w ɛ ˦˩
hoạ	h w aː ˨˩ ʔ
hoạn	h w aː ŋ ˨˩ ʔ
hoả	h w aː ˧˨
hoảng	h w aː ŋ ˧˨
hoắc	h w a k̚ ˦˧˥
hoẵng	h w a ŋ ˧˨
hoặc	h w a k̚ ˨˩ ʔ
hrê	h ɹ e j ˧˧
hun	h u n ˧˧
hung	h ʊ w ŋ͡m ˧˧
huy	h w ɪ j ˧˧
huynh	h w ɨ n ˧˧
huyết	h w i ə k̚ ˦˧˥
huyền	h w i ə ŋ ˦˩
huyện	h w i ə ŋ ˨˩ ʔ
huyệt	h w i ə k̚ ˨˩ ʔ
huân	h w ə ŋ ˧˧
huýt	h w ɨ t̚ ˦˧˥
huơ	h w əː ˧˧
huế	h w e j ˨˩˦
huề	h w e j ˦˩
huệ	h w e j ˨˩ ʔ
huống	h u ə ŋ ˦˧˥
huỳnh	h w ɨ n ˦˩
huỷ	h w ɪ j ˧˨
hyginô	h ɪ j ˧˧ j ɪ j ˧˧ n o w ˧˧
hypebol	h ɪ j ˧˧ p ɛ ˧˧ ʔ ɓ ɔ ŋ ˧˧
hà	h aː ˦˩
hài	h aː j ˦˩
hàm	h aː m ˦˩
hàn	h aː ŋ ˦˩
hàng	h aː ŋ ˦˩
hành	h ɛ ɲ ˦˩
hào	h a w ˦˩
hào	h aː w ˦˩
hàu	h a w ˦˩
há	h aː ˨˩˦
hái	h aː j ˨˩˦
hán	h aː ŋ ˦˧˥
háng	h aː ŋ ˦˧˥
háo	h aː w ˨˩˦
hát	h aː k̚ ˦˧˥
hâm	h ə m ˧˧
hãi	h aː j ˧˨
hãm	h aː m ˧˨
hãn	h aː ŋ ˧˨
hãng	h aː ŋ ˧˨
hãy	h a j ˧˨
hè	h ɛ ˦˩
hèm	h ɛ m ˦˩
hèn	h ɛ ŋ ˦˩
hé	h ɛ ˨˩˦
héo	h ɛ w ˨˩˦
hét	h ɛ t̚ ˦˧˥
hên	h e n ˧˧
hình	h ɨ n ˦˩
hí	h ɪ j ˨˩˦
hít	h i t̚ ˦˧˥
hò	h ɔ ˦˩
hòm	h ɔ m ˦˩
hòn	h ɔ ŋ ˦˩
hòng	h a w ŋ͡m ˦˩
hóc	h a w k͡p̚ ˦˧˥
hói	h ɔ j ˨˩˦
hóng	h a w ŋ͡m ˦˧˥
hóp	h ɔ p̚ ˦˧˥
hót	h ɔ k̚ ˦˧˥
hô	h o w ˧˧
hôi	h o j ˧˧
hôm	h o m ˧˧
hôn	h o ŋ ˧˧
hông	h ə w ŋ͡m ˧˧
hù	h ʊ w ˦˩
hùa	h u ə ˦˩
hùm	h u m ˦˩
hùng	h ʊ w ŋ͡m ˦˩
hú	h ʊ w ˨˩˦
húc	h ʊ w k͡p̚ ˦˧˥
húp	h u p̚ ˦˧˥
hút	h ʊ k̚ ˦˧˥
hăm	h a m ˧˧
hăng	h a ŋ ˧˧
hĩm	h i m ˧˨
hũ	h ʊ w ˧˨
hơ	h əː ˧˧
hơi	h əː j ˧˧
hơn	h əː ŋ ˧˧
hư	h ɨ ˧˧
hưu	h ɨ w ˧˧
hương	h ɨ ə ŋ ˧˧
hươu	h ɨ ə w ˧˧
hướng	h ɨ ə ŋ ˦˧˥
hường	h ɨ ə ŋ ˦˩
hưởng	h ɨ ə ŋ ˧˨
hạ	h aː ˨˩ ʔ
hạc	h aː k̚ ˨˩ ʔ
hạch	h a t̚ ˨˩ ʔ
hại	h aː j ˨˩ ʔ
hạm	h aː m ˨˩ ʔ
hạn	h aː ŋ ˨˩ ʔ
hạng	h aː ŋ ˨˩ ʔ
hạnh	h ɛ ɲ ˨˩ ʔ
hạo	h aː w ˨˩ ʔ
hạp	h aː p̚ ˨˩ ʔ
hạt	h aː k̚ ˨˩ ʔ
hả	h aː ˧˨
hải	h aː j ˧˨
hảo	h aː w ˧˨
hấp	h ə p̚ ˦˧˥
hất	h ə k̚ ˦˧˥
hầm	h ə m ˦˩
hầu	h ə w ˦˩
hẩy	h ə j ˧˨
hận	h ə ŋ ˨˩ ʔ
hậu	h ə w ˨˩ ʔ
hắc	h a k̚ ˦˧˥
hắn	h a ŋ ˦˧˥
hắt	h a k̚ ˦˧˥
hằng	h a ŋ ˦˩
hẳn	h a ŋ ˧˨
hẵng	h a ŋ ˧˨
hẹ	h ɛ ˨˩ ʔ
hẹn	h ɛ ŋ ˨˩ ʔ
hẹp	h ɛ p̚ ˨˩ ʔ
hẻm	h ɛ m ˧˨
hếch	h e t̚ ˦˧˥
hến	h e n ˦˧˥
hết	h e t̚ ˦˧˥
hề	h e j ˦˩
hễ	h e j ˧˨
hệch	h e t̚ ˨˩ ʔ
hệt	h e t̚ ˨˩ ʔ
hỉ	h ɪ j ˧˨
hịch	h ɨ t̚ ˨˩ ʔ
họ	h ɔ ˨˩ ʔ
học	h a w k͡p̚ ˨˩ ʔ
họng	h a w ŋ͡m ˨˩ ʔ
họp	h ɔ p̚ ˨˩ ʔ
hỏi	h ɔ j ˧˨
hỏng	h a w ŋ͡m ˧˨
hố	h o w ˨˩˦
hốc	h ə w k͡p̚ ˦˧˥
hối	h o j ˨˩˦
hốt	h o k̚ ˦˧˥
hồ	h o w ˦˩
hồi	h o j ˦˩
hồn	h o ŋ ˦˩
hồng	h ə w ŋ͡m ˦˩
hổ	h o w ˧˨
hổi	h o j ˧˨
hổm	h o m ˧˨
hổng	h ə w ŋ͡m ˧˨
hỗ	h o w ˧˨
hỗn	h o ŋ ˧˨
hộ	h o w ˨˩ ʔ
hộc	h ə w k͡p̚ ˨˩ ʔ
hội	h o j ˨˩ ʔ
hộp	h o p̚ ˨˩ ʔ
hột	h o k̚ ˨˩ ʔ
hớn	h əː ŋ ˦˧˥
hớp	h əː p̚ ˦˧˥
hớt	h əː k̚ ˦˧˥
hời	h əː j ˦˩
hờn	h əː ŋ ˦˩
hở	h əː ˧˨
hỡi	h əː j ˧˨
hợi	h əː j ˨˩ ʔ
hợm	h əː m ˨˩ ʔ
hợp	h əː p̚ ˨˩ ʔ
hụ	h ʊ w ˨˩ ʔ
hụp	h u p̚ ˨˩ ʔ
hụt	h ʊ k̚ ˨˩ ʔ
hủ	h ʊ w ˧˨
hứa	h ɨ ə ˨˩˦
hức	h ɨ k̚ ˦˧˥
hứng	h ɨ ŋ ˦˧˥
hử	h ɨ ˧˨
hửi	h ɨ j ˧˨
hửng	h ɨ ŋ ˧˨
hữu	h ɨ w ˧˨
i	ʔ ɪ j ˧˧
im	ʔ i m ˧˧
in	ʔ i n ˧˧
inh	ʔ ɨ n ˧˧
inhaxiô	ʔ ɪ j ˧˧ ɲ aː ˧˧ s ɪ j ˧˧ ʔ o w ˧˧
inđi	ʔ i n ˧˧ ʔ ɗ ɪ j ˧˧
ion	ʔ ɪ j ˧˧ ʔ ə w ŋ͡m ˧˧
iot	ʔ ɪ j ˧˧ ʔ o k̚ ˦˧˥
iriđi	ʔ ɪ j ˧˧ ɹ ɪ j ˧˧ ʔ ɗ ɪ j ˧˧
isave	ʔ ɪ j ˧˧ ʂ aː ˧˧ v ɛ ˧˧
iu	ʔ i w ˧˧
k	k aː ˧˧
kaki	k aː ˧˧ k ɪ j ˧˧
kali	k aː ˧˧ l ɪ j ˧˧
ke	k ɛ ˧˧
kem	k ɛ m ˧˧
ken	k ɛ ŋ ˧˧
keng	k ɛ ŋ ˧˧
kenvin	k ɛ ŋ ˧˧ v i n ˧˧
keo	k ɛ w ˧˧
khai	kʰ aː j ˧˧
khan	kʰ aː ŋ ˧˧
khanh	kʰ ɛ ɲ ˧˧
khay	kʰ a j ˧˧
khe	kʰ ɛ ˧˧
khen	kʰ ɛ ŋ ˧˧
khi	kʰ ɪ j ˧˧
khinh	kʰ ɨ n ˧˧
khiên	kʰ i ə ŋ ˧˧
khiêng	kʰ i ə ŋ ˧˧
khiến	kʰ i ə ŋ ˦˧˥
khiếp	kʰ i ə p̚ ˦˧˥
khiếu	kʰ i w ˨˩˦
kho	kʰ ɔ ˧˧
khoa	kʰ w aː ˧˧
khoai	kʰ w aː j ˧˧
khoan	kʰ w aː ŋ ˧˧
khoang	kʰ w aː ŋ ˧˧
khoanh	kʰ w ɛ ɲ ˧˧
khoe	kʰ w ɛ ˧˧
khoeo	kʰ w ɛ w ˧˧
khom	kʰ ɔ m ˧˧
khoá	kʰ w aː ˨˩˦
khoác	kʰ w aː k̚ ˦˧˥
khoái	kʰ w aː j ˨˩˦
khoán	kʰ w aː ŋ ˦˧˥
khoáng	kʰ w aː ŋ ˦˧˥
khoát	kʰ w aː k̚ ˦˧˥
khoé	kʰ w ɛ ˨˩˦
khoét	kʰ w ɛ k̚ ˦˧˥
khoả	kʰ w aː ˧˨
khoản	kʰ w aː ŋ ˧˨
khoảng	kʰ w aː ŋ ˧˨
khoảnh	kʰ w ɛ ɲ ˧˨
khoằm	kʰ w a m ˦˩
khoẻ	kʰ w ɛ ˧˨
khu	kʰ ʊ w ˧˧
khui	kʰ u j ˧˧
khum	kʰ u m ˧˧
khung	kʰ ʊ w ŋ͡m ˧˧
khuy	kʰ w ɪ j ˧˧
khuya	kʰ w i ə ˧˧
khuyên	kʰ w i ə ŋ ˧˧
khuyến	kʰ w i ə ŋ ˦˧˥
khuyết	kʰ w i ə k̚ ˦˧˥
khuân	kʰ w ə ŋ ˧˧
khuôn	kʰ u ə ŋ ˧˧
khuất	kʰ w ə k̚ ˦˧˥
khuấy	kʰ w ə j ˨˩˦
khuếch	kʰ w e t̚ ˦˧˥
khuỷu	kʰ w i w ˧˨
khàn	kʰ aː ŋ ˦˩
khá	kʰ aː ˨˩˦
khác	kʰ aː k̚ ˦˧˥
khách	kʰ a t̚ ˦˧˥
khái	kʰ aː j ˨˩˦
khám	kʰ aː m ˦˧˥
khán	kʰ aː ŋ ˦˧˥
kháng	kʰ aː ŋ ˦˧˥
khánh	kʰ ɛ ɲ ˦˧˥
khát	kʰ aː k̚ ˦˧˥
kháy	kʰ a j ˨˩˦
khâu	kʰ ə w ˧˧
khéo	kʰ ɛ w ˨˩˦
khép	kʰ ɛ p̚ ˦˧˥
khét	kʰ ɛ t̚ ˦˧˥
khê	kʰ e j ˧˧
khêu	kʰ e w ˧˧
khí	kʰ ɪ j ˨˩˦
khía	kʰ i ə ˨˩˦
khích	kʰ ɨ t̚ ˦˧˥
khít	kʰ i t̚ ˦˧˥
khó	kʰ ɔ ˨˩˦
khóc	kʰ a w k͡p̚ ˦˧˥
khói	kʰ ɔ j ˨˩˦
khóm	kʰ ɔ m ˦˧˥
khô	kʰ o w ˧˧
khôi	kʰ o j ˧˧
khôn	kʰ o ŋ ˧˧
không	kʰ ə w ŋ͡m ˧˧
khùng	kʰ ʊ w ŋ͡m ˦˩
khúc	kʰ ʊ w k͡p̚ ˦˧˥
khăm	kʰ a m ˧˧
khăn	kʰ a ŋ ˧˧
khơi	kʰ əː j ˧˧
khương	kʰ ɨ ə ŋ ˧˧
khạc	kʰ aː k̚ ˨˩ ʔ
khả	kʰ aː ˧˨
khải	kʰ aː j ˧˨
khảnh	kʰ ɛ ɲ ˧˨
khảo	kʰ aː w ˧˨
khảy	kʰ a j ˧˨
khấn	kʰ ə ŋ ˦˧˥
khấu	kʰ ə w ˨˩˦
khẩu	kʰ ə w ˧˨
khắc	kʰ a k̚ ˦˧˥
khắm	kʰ a m ˦˧˥
khắp	kʰ a p̚ ˦˧˥
khẳn	kʰ a ŋ ˧˨
khẹc	kʰ ɛ k̚ ˨˩ ʔ
khẽ	kʰ ɛ ˧˨
khế	kʰ e j ˨˩˦
khều	kʰ e w ˦˩
khểnh	kʰ e n ˧˨
khỉ	kʰ ɪ j ˧˨
khịt	kʰ i t̚ ˨˩ ʔ
khỏ	kʰ ɔ ˧˨
khỏi	kʰ ɔ j ˧˨
khố	kʰ o w ˨˩˦
khối	kʰ o j ˨˩˦
khổ	kʰ o w ˧˨
khổng	kʰ ə w ŋ͡m ˧˨
khớp	kʰ əː p̚ ˦˧˥
khờ	kʰ əː ˦˩
khủng	kʰ ʊ w ŋ͡m ˧˨
khứa	kʰ ɨ ə ˨˩˦
khứng	kʰ ɨ ŋ ˦˧˥
khử	kʰ ɨ ˧˨
khựa	kʰ ɨ ə ˨˩ ʔ
khựng	kʰ ɨ ŋ ˨˩ ʔ
ki	k ɪ j ˧˧
kia	k i ə ˧˧
kilôgam	k ɪ j ˧˧ l o w ˧˧ ɣ aː m ˧˧
kilômet	k ɪ j ˧˧ l o w ˧˧ m ɛ t̚ ˦˧˥
kilômét	k ɪ j ˧˧ l o w ˧˧ m ɛ t̚ ˦˧˥
kilôoat	k ɪ j ˧˧ l o w ˧˧ ʔ w aː k̚ ˦˧˥
kim	k i m ˧˧
kinh	k ɨ n ˧˧
kirixitô	k ɪ j ˧˧ ʐ ɪ j ˧˧ s ɪ j ˧˧ t o w ˧˧
kiêm	k i ə m ˧˧
kiên	k i ə ŋ ˧˧
kiêng	k i ə ŋ ˧˧
kiêu	k i w ˧˧
kiếm	k i ə m ˦˧˥
kiến	k i ə ŋ ˦˧˥
kiếng	k i ə ŋ ˦˧˥
kiếp	k i ə p̚ ˦˧˥
kiết	k i ə k̚ ˦˧˥
kiếu	k i w ˨˩˦
kiềm	k i ə m ˦˩
kiều	k i w ˦˩
kiểm	k i ə m ˧˨
kiểng	k i ə ŋ ˧˨
kiểu	k i w ˧˨
kiện	k i ə ŋ ˨˩ ʔ
kiệt	k i ə k̚ ˨˩ ʔ
kiệu	k i w ˨˩ ʔ
koala	k o w ˧˧ ʔ aː ˧˧ l aː ˧˧
kripton	k ɹ i p̚ ˦˧˥ t ə w ŋ͡m ˧˧
kute	k ʊ w ˧˧ t ɛ ˧˧
kè	k ɛ ˦˩
kèm	k ɛ m ˦˩
kèn	k ɛ ŋ ˦˩
kèo	k ɛ w ˦˩
ké	k ɛ ˨˩˦
kém	k ɛ m ˦˧˥
kén	k ɛ ŋ ˦˧˥
kéo	k ɛ w ˨˩˦
kép	k ɛ p̚ ˦˧˥
két	k ɛ t̚ ˦˧˥
kê	k e j ˧˧
kênh	k e n ˧˧
kêu	k e w ˧˧
kì	k ɪ j ˦˩
kìa	k i ə ˦˩
kìm	k i m ˦˩
kình	k ɨ n ˦˩
kí	k ɪ j ˨˩˦
kích	k ɨ t̚ ˦˧˥
kín	k i n ˦˧˥
kính	k ɨ n ˦˧˥
kíp	k i p̚ ˦˧˥
kĩ	k ɪ j ˧˨
kẹc	k ɛ k̚ ˨˩ ʔ
kẹo	k ɛ w ˨˩ ʔ
kẹp	k ɛ p̚ ˨˩ ʔ
kẹt	k ɛ t̚ ˨˩ ʔ
kẻ	k ɛ ˧˨
kẻng	k ɛ ŋ ˧˨
kẻo	k ɛ w ˧˨
kẽ	k ɛ ˧˨
kẽm	k ɛ m ˧˨
kế	k e j ˨˩˦
kếch	k e t̚ ˦˧˥
kết	k e t̚ ˦˧˥
kề	k e j ˦˩
kền	k e n ˦˩
kềnh	k e n ˦˩
kể	k e j ˧˨
kệ	k e j ˨˩ ʔ
kệch	k e t̚ ˨˩ ʔ
kỉ	k ɪ j ˧˨
kịch	k ɨ t̚ ˨˩ ʔ
kịp	k i p̚ ˨˩ ʔ
l	ʔ ɛ ˧˧ l əː ˦˩
la	l aː ˧˧
lai	l aː j ˧˧
lam	l aː m ˧˧
lan	l aː ŋ ˧˧
lang	l aː ŋ ˧˧
lanh	l ɛ ɲ ˧˧
lantan	l aː n ˧˧ t aː n ˧˧
lao	l aː w ˧˧
latinh	l aː ˧˧ t ɨ n ˧˧
lau	l a w ˧˧
lay	l a j ˧˧
le	l ɛ ˧˧
lem	l ɛ m ˧˧
len	l ɛ ŋ ˧˧
leo	l ɛ w ˧˧
li	l ɪ j ˧˧
lia	l i ə ˧˧
lim	l i m ˧˧
linh	l ɨ n ˧˧
linô	l i n ˧˧ n o w ˧˧
liti	l ɪ j ˧˧ t ɪ j ˧˧
livermori	l ɪ j ˧˧ v əː ˧˧ m ɔ ˧˧ ɹ ɪ j ˧˧
liêm	l i ə m ˧˧
liên	l i ə ŋ ˧˧
liếc	l i ə k̚ ˦˧˥
liếm	l i ə m ˦˧˥
liềm	l i ə m ˦˩
liền	l i ə ŋ ˦˩
liều	l i w ˦˩
liễu	l i w ˧˨
liệng	l i ə ŋ ˨˩ ʔ
liệt	l i ə k̚ ˨˩ ʔ
liệu	l i w ˨˩ ʔ
lo	l ɔ ˧˧
loa	l w aː ˧˧
loan	l w aː ŋ ˧˧
loang	l w aː ŋ ˧˧
lon	l ɔ ŋ ˧˧
long	l a w ŋ͡m ˧˧
lorenxi	l ɔ ˧˧ ɹ ɛ ŋ ˧˧ s ɪ j ˧˧
loài	l w aː j ˦˩
loá	l w aː ˨˩˦
loán	l w aː ŋ ˦˧˥
loãng	l w aː ŋ ˧˨
loè	l w ɛ ˦˩
loé	l w ɛ ˨˩˦
loét	l w ɛ k̚ ˦˧˥
loại	l w aː j ˨˩ ʔ
loạn	l w aː ŋ ˨˩ ʔ
loạt	l w aː k̚ ˨˩ ʔ
lu	l ʊ w ˧˧
luca	l ʊ w ˧˧ k aː ˧˧
luciô	l ʊ w ˧˧ s ɪ j ˧˧ ʔ o w ˧˧
lui	l u j ˧˧
lung	l ʊ w ŋ͡m ˧˧
lutexi	l ʊ w ˧˧ t e j ˧˧ s ɪ j ˧˧
luyến	l w i ə ŋ ˦˧˥
luyện	l w i ə ŋ ˨˩ ʔ
luân	l w ə ŋ ˧˧
luôn	l u ə ŋ ˧˧
luận	l w ə ŋ ˨˩ ʔ
luật	l w ə k̚ ˨˩ ʔ
luốc	l u ə k̚ ˦˧˥
luống	l u ə ŋ ˦˧˥
luồn	l u ə ŋ ˦˩
luồng	l u ə ŋ ˦˩
luộc	l u ə k̚ ˨˩ ʔ
luỹ	l w ɪ j ˧˨
là	l aː ˦˩
lài	l aː j ˦˩
làm	l aː m ˦˩
làn	l aː ŋ ˦˩
làng	l aː ŋ ˦˩
lành	l ɛ ɲ ˦˩
lào	l aː w ˦˩
lá	l aː ˨˩˦
lác	l aː k̚ ˦˧˥
lách	l a t̚ ˦˧˥
lái	l aː j ˨˩˦
lán	l aː ŋ ˦˧˥
láng	l aː ŋ ˦˧˥
lánh	l ɛ ɲ ˦˧˥
láo	l aː w ˨˩˦
lát	l aː k̚ ˦˧˥
láy	l a j ˨˩˦
lâm	l ə m ˧˧
lân	l ə ŋ ˧˧
lâu	l ə w ˧˧
lây	l ə j ˧˧
lãi	l aː j ˧˨
lãng	l aː ŋ ˧˨
lãnh	l ɛ ɲ ˧˨
lão	l aː w ˧˨
lè	l ɛ ˦˩
lé	l ɛ ˨˩˦
lén	l ɛ ŋ ˦˧˥
lép	l ɛ p̚ ˦˧˥
lê	l e j ˧˧
lên	l e n ˧˧
lêô	l e j ˧˧ ʔ o w ˧˧
lì	l ɪ j ˦˩
lìa	l i ə ˦˩
lìn	l i n ˦˩
lí	l ɪ j ˨˩˦
lính	l ɨ n ˦˧˥
líp	l i p̚ ˦˧˥
lít	l i t̚ ˦˧˥
lò	l ɔ ˦˩
lòi	l ɔ j ˦˩
lòn	l ɔ ŋ ˦˩
lòng	l a w ŋ͡m ˦˩
ló	l ɔ ˨˩˦
lóc	l a w k͡p̚ ˦˧˥
lóng	l a w ŋ͡m ˦˧˥
lót	l ɔ k̚ ˦˧˥
lôgarit	l o w ˧˧ ɣ aː ˧˧ ɹ i t̚ ˧˧
lôgic	l o w ˧˧ j ɨ t̚ ˦˧˥
lôi	l o j ˧˧
lông	l ə w ŋ͡m ˧˧
lôrensô	l o w ˧˧ ʐ ɛ ŋ ˧˧ ʂ o w ˧˧
lõ	l ɔ ˧˨
lõi	l ɔ j ˧˨
lõm	l ɔ m ˧˨
lõng	l a w ŋ͡m ˧˨
lùa	l u ə ˦˩
lùi	l u j ˦˩
lùm	l u m ˦˩
lùn	l u n ˦˩
lùng	l ʊ w ŋ͡m ˦˩
lú	l ʊ w ˨˩˦
lúa	l u ə ˨˩˦
lúc	l ʊ w k͡p̚ ˦˧˥
lún	l u n ˦˧˥
lăm	l a m ˧˧
lăn	l a ŋ ˧˧
lăng	l a ŋ ˧˧
lĩnh	l ɨ n ˧˨
lũ	l ʊ w ˧˨
lơ	l əː ˧˧
lơi	l əː j ˧˧
lưng	l ɨ ŋ ˧˧
lưu	l ɨ w ˧˧
lươn	l ɨ ə ŋ ˧˧
lương	l ɨ ə ŋ ˧˧
lưới	l ɨ j ˨˩˦
lướt	l ɨ ə k̚ ˦˧˥
lười	l ɨ j ˦˩
lườm	l ɨ ə m ˦˩
lườn	l ɨ ə ŋ ˦˩
lường	l ɨ ə ŋ ˦˩
lưỡi	l ɨ j ˧˨
lược	l ɨ ə k̚ ˨˩ ʔ
lượm	l ɨ ə m ˨˩ ʔ
lượn	l ɨ ə ŋ ˨˩ ʔ
lượng	l ɨ ə ŋ ˨˩ ʔ
lượt	l ɨ ə k̚ ˨˩ ʔ
lạ	l aː ˨˩ ʔ
lạc	l aː k̚ ˨˩ ʔ
lạch	l a t̚ ˨˩ ʔ
lại	l aː j ˨˩ ʔ
lạng	l aː ŋ ˨˩ ʔ
lạnh	l ɛ ɲ ˨˩ ʔ
lạt	l aː k̚ ˨˩ ʔ
lạy	l a j ˨˩ ʔ
lảng	l aː ŋ ˧˨
lấm	l ə m ˦˧˥
lấn	l ə ŋ ˦˧˥
lấp	l ə p̚ ˦˧˥
lấy	l ə j ˨˩˦
lầm	l ə m ˦˩
lần	l ə ŋ ˦˩
lầu	l ə w ˦˩
lầy	l ə j ˦˩
lẩn	l ə ŋ ˧˨
lẩu	l ə w ˧˨
lẫn	l ə ŋ ˧˨
lẫy	l ə j ˧˨
lận	l ə ŋ ˨˩ ʔ
lập	l ə p̚ ˨˩ ʔ
lật	l ə k̚ ˨˩ ʔ
lậu	l ə w ˨˩ ʔ
lắc	l a k̚ ˦˧˥
lắm	l a m ˦˧˥
lắng	l a ŋ ˦˧˥
lắp	l a p̚ ˦˧˥
lằn	l a ŋ ˦˩
lẵng	l a ŋ ˧˨
lặn	l a ŋ ˨˩ ʔ
lặng	l a ŋ ˨˩ ʔ
lặp	l a p̚ ˨˩ ʔ
lặt	l a k̚ ˨˩ ʔ
lẹ	l ɛ ˨˩ ʔ
lẹo	l ɛ w ˨˩ ʔ
lẻ	l ɛ ˧˨
lẻn	l ɛ ŋ ˧˨
lẽ	l ɛ ˧˨
lết	l e t̚ ˦˧˥
lề	l e j ˦˩
lều	l e w ˦˩
lễ	l e j ˧˨
lệ	l e j ˨˩ ʔ
lệch	l e t̚ ˨˩ ʔ
lệnh	l e n ˨˩ ʔ
lị	l ɪ j ˨˩ ʔ
lịch	l ɨ t̚ ˨˩ ʔ
lịm	l i m ˨˩ ʔ
lọ	l ɔ ˨˩ ʔ
lọc	l a w k͡p̚ ˨˩ ʔ
lọn	l ɔ ŋ ˨˩ ʔ
lọt	l ɔ k̚ ˨˩ ʔ
lỏm	l ɔ m ˧˨
lỏng	l a w ŋ͡m ˧˨
lố	l o w ˨˩˦
lốc	l ə w k͡p̚ ˦˧˥
lối	l o j ˨˩˦
lốp	l o p̚ ˦˧˥
lốt	l o k̚ ˦˧˥
lồi	l o j ˦˩
lồn	l o ŋ ˦˩
lồng	l ə w ŋ͡m ˦˩
lỗ	l o w ˧˨
lỗi	l o j ˧˨
lộ	l o w ˨˩ ʔ
lộc	l ə w k͡p̚ ˨˩ ʔ
lội	l o j ˨˩ ʔ
lộn	l o ŋ ˨˩ ʔ
lộng	l ə w ŋ͡m ˨˩ ʔ
lột	l o k̚ ˨˩ ʔ
lớn	l əː ŋ ˦˧˥
lớp	l əː p̚ ˦˧˥
lờ	l əː ˦˩
lời	l əː j ˦˩
lờn	l əː ŋ ˦˩
lở	l əː ˧˨
lỡ	l əː ˧˨
lợi	l əː j ˨˩ ʔ
lợn	l əː ŋ ˨˩ ʔ
lợp	l əː p̚ ˨˩ ʔ
lụa	l u ə ˨˩ ʔ
lục	l ʊ w k͡p̚ ˨˩ ʔ
lụm	l u m ˨˩ ʔ
lụt	l ʊ k̚ ˨˩ ʔ
lủng	l ʊ w ŋ͡m ˧˨
lứa	l ɨ ə ˨˩˦
lừa	l ɨ ə ˦˩
lừng	l ɨ ŋ ˦˩
lửa	l ɨ ə ˧˨
lửng	l ɨ ŋ ˧˨
lự	l ɨ ˨˩ ʔ
lựa	l ɨ ə ˨˩ ʔ
lực	l ɨ k̚ ˨˩ ʔ
lựu	l ɨ w ˨˩ ʔ
m	ʔ ɛ ˧˧ m əː ˦˩
m'nông	m əː ˧˧ n ə w ŋ͡m ˧˧
ma	m aː ˧˧
magie	m aː ˧˧ j e j ˧˧
mai	m aː j ˧˧
man	m aː ŋ ˧˧
mang	m aː ŋ ˧˧
mangan	m aː ŋ ˧˧ ɣ aː ŋ ˧˧
manh	m ɛ ɲ ˧˧
maria	m aː ˧˧ ʐ ɪ j ˧˧ ʔ aː ˧˧
maroc	m aː ˧˧ ɹ ə w k͡p̚ ˦˧˥
martinô	m aː ˧˧ t i n ˧˧ n o w ˧˧
mau	m a w ˧˧
may	m a j ˧˧
mc	ʔ ɛ m ˧˧ s ɪ j ˧˧
me	m ɛ ˧˧
men	m ɛ ŋ ˧˧
menđelevi	m ɛ ŋ ˧˧ ʔ ɗ e j ˧˧ l e j ˧˧ v ɪ j ˧˧
meo	m ɛ w ˧˧
mi	m ɪ j ˧˧
micae	m ɪ j ˧˧ k aː ˧˧ ʔ ɛ ˧˧
min	m i n ˧˧
minh	m ɨ n ˧˧
miu	m i w ˧˧
miên	m i ə ŋ ˧˧
miến	m i ə ŋ ˦˧˥
miếng	m i ə ŋ ˦˧˥
miếu	m i w ˨˩˦
miền	m i ə ŋ ˦˩
miểng	m i ə ŋ ˧˨
miễn	m i ə ŋ ˧˨
miệng	m i ə ŋ ˨˩ ʔ
mo	m ɔ ˧˧
moa	m w aː ˧˧
modem	m o w ˧˧ ʔ ɗ e m ˧˧
moi	m ɔ j ˧˧
mol	m ɔ ŋ ˧˧
molipđen	m o w ˧˧ l i p̚ ˦˧˥ ʔ ɗ ɛ ŋ ˧˧
mong	m a w ŋ͡m ˧˧
moóc	m ɔ k̚ ˦˧˥
moạ	m w aː ˨˩ ʔ
moả	m w aː ˧˨
mtdtgpmnvn	m a k̚ ˨˩ ʔ ʈ ə ŋ ˨˩ ʔ j ə ŋ ˧˧ t ə w k͡p̚ ˨˩ ʔ j aː j ˧˨ f a w ŋ͡m ˦˧˥ m i ə ŋ ˦˩ n aː m ˧˧ v i ə k̚ ˨˩ ʔ n aː m ˧˧
mu	m ʊ w ˧˧
mua	m u ə ˧˧
mui	m u j ˧˧
mun	m u n ˧˧
muôi	m u j ˧˧
muôn	m u ə ŋ ˧˧
muông	m u ə ŋ ˧˧
muối	m u j ˨˩˦
muốn	m u ə ŋ ˦˧˥
muống	m u ə ŋ ˦˧˥
muỗi	m u j ˧˨
muỗng	m u ə ŋ ˧˨
muội	m u j ˨˩ ʔ
muộn	m u ə ŋ ˨˩ ʔ
mà	m aː ˦˩
mài	m aː j ˦˩
màn	m aː ŋ ˦˩
màng	m aː ŋ ˦˩
mào	m aː w ˦˩
màu	m a w ˦˩
mày	m a j ˦˩
má	m aː ˨˩˦
mác	m aː k̚ ˦˧˥
máccô	m aː k̚ ˦˧˥ k o w ˧˧
mách	m a t̚ ˦˧˥
máctinô	m aː k̚ ˦˧˥ t ɪ j ˧˧ n o w ˧˧
mái	m aː j ˨˩˦
máng	m aː ŋ ˦˧˥
mánh	m ɛ ɲ ˦˧˥
mát	m aː k̚ ˦˧˥
mátthêu	m aː k̚ ˦˧˥ tʰ e w ˧˧
máu	m a w ˨˩˦
máy	m a j ˨˩˦
mâm	m ə m ˧˧
mân	m ə ŋ ˧˧
mây	m ə j ˧˧
mã	m aː ˧˨
mãi	m aː j ˧˨
mãn	m aː ŋ ˧˨
mão	m aː w ˧˨
mè	m ɛ ˦˩
mèm	m ɛ m ˦˩
mèo	m ɛ w ˦˩
mé	m ɛ ˨˩˦
méc	m ɛ k̚ ˦˧˥
mén	m ɛ ŋ ˦˧˥
méo	m ɛ w ˨˩˦
mép	m ɛ p̚ ˦˧˥
mét	m ɛ t̚ ˦˧˥
mê	m e j ˧˧
mì	m ɪ j ˦˩
mìn	m i n ˦˩
mình	m ɨ n ˦˩
mí	m ɪ j ˨˩˦
mía	m i ə ˨˩˦
mím	m i m ˦˧˥
mít	m i t̚ ˦˧˥
mò	m ɔ ˦˩
mòn	m ɔ ŋ ˦˩
mòng	m a w ŋ͡m ˦˩
mó	m ɔ ˨˩˦
móc	m a w k͡p̚ ˦˧˥
móm	m ɔ m ˦˧˥
món	m ɔ ŋ ˦˧˥
móng	m a w ŋ͡m ˦˧˥
móp	m ɔ p̚ ˦˧˥
mót	m ɔ k̚ ˦˧˥
mô	m o w ˧˧
môi	m o j ˧˧
môn	m o ŋ ˧˧
mông	m ə w ŋ͡m ˧˧
mônica	m o ŋ ˧˧ n ɪ j ˧˧ k aː ˧˧
mõ	m ɔ ˧˨
mõm	m ɔ m ˧˨
mù	m ʊ w ˦˩
mùa	m u ə ˦˩
mùi	m u j ˦˩
mùn	m u n ˦˩
mùng	m ʊ w ŋ͡m ˦˩
múa	m u ə ˨˩˦
múc	m ʊ w k͡p̚ ˦˧˥
múi	m u j ˨˩˦
múp	m u p̚ ˦˧˥
mút	m ʊ k̚ ˦˧˥
măm	m a m ˧˧
măng	m a ŋ ˧˧
mĩ	m ɪ j ˧˨
mũ	m ʊ w ˧˨
mũi	m u j ˧˨
mơ	m əː ˧˧
mưa	m ɨ ə ˧˧
mưu	m ɨ w ˧˧
mươi	m ɨ j ˧˧
mương	m ɨ ə ŋ ˧˧
mướn	m ɨ ə ŋ ˦˧˥
mướp	m ɨ ə p̚ ˦˧˥
mướt	m ɨ ə k̚ ˦˧˥
mười	m ɨ j ˦˩
mường	m ɨ ə ŋ ˦˩
mượn	m ɨ ə ŋ ˨˩ ʔ
mượt	m ɨ ə k̚ ˨˩ ʔ
mạ	m aː ˨˩ ʔ
mạc	m aː k̚ ˨˩ ʔ
mạch	m a t̚ ˨˩ ʔ
mạn	m aː ŋ ˨˩ ʔ
mạng	m aː ŋ ˨˩ ʔ
mạnh	m ɛ ɲ ˨˩ ʔ
mạo	m aː w ˨˩ ʔ
mạt	m aː k̚ ˨˩ ʔ
mả	m aː ˧˨
mải	m aː j ˧˨
mảng	m aː ŋ ˧˨
mảnh	m ɛ ɲ ˧˨
mấn	m ə ŋ ˦˧˥
mất	m ə k̚ ˦˧˥
mấu	m ə w ˨˩˦
mấy	m ə j ˨˩˦
mầm	m ə m ˦˩
mần	m ə ŋ ˦˩
mầu	m ə w ˦˩
mầy	m ə j ˦˩
mẩu	m ə w ˧˨
mẩy	m ə j ˧˨
mẫn	m ə ŋ ˧˨
mẫu	m ə w ˧˨
mận	m ə ŋ ˨˩ ʔ
mập	m ə p̚ ˨˩ ʔ
mật	m ə k̚ ˨˩ ʔ
mậu	m ə w ˨˩ ʔ
mắc	m a k̚ ˦˧˥
mắm	m a m ˦˧˥
mắn	m a ŋ ˦˧˥
mắng	m a ŋ ˦˧˥
mắt	m a k̚ ˦˧˥
mặc	m a k̚ ˨˩ ʔ
mặn	m a ŋ ˨˩ ʔ
mặt	m a k̚ ˨˩ ʔ
mẹ	m ɛ ˨˩ ʔ
mẹo	m ɛ w ˨˩ ʔ
mẻ	m ɛ ˧˨
mẽ	m ɛ ˧˨
mến	m e n ˦˧˥
mếu	m e w ˨˩˦
mề	m e j ˦˩
mềm	m e m ˦˩
mền	m e n ˦˩
mễ	m e j ˧˨
mệ	m e j ˨˩ ʔ
mệnh	m e n ˨˩ ʔ
mệt	m e t̚ ˨˩ ʔ
mỉa	m i ə ˧˨
mỉm	m i m ˧˨
mịn	m i n ˨˩ ʔ
mịt	m i t̚ ˨˩ ʔ
mọc	m a w k͡p̚ ˨˩ ʔ
mọi	m ɔ j ˨˩ ʔ
mọn	m ɔ ŋ ˨˩ ʔ
mọng	m a w ŋ͡m ˨˩ ʔ
mọt	m ɔ k̚ ˨˩ ʔ
mỏ	m ɔ ˧˨
mỏi	m ɔ j ˧˨
mỏng	m a w ŋ͡m ˧˨
mốc	m ə w k͡p̚ ˦˧˥
mối	m o j ˨˩˦
mống	m ə w ŋ͡m ˦˧˥
mốt	m o k̚ ˦˧˥
mồ	m o w ˦˩
mồi	m o j ˦˩
mồm	m o m ˦˩
mồng	m ə w ŋ͡m ˦˩
mổ	m o w ˧˨
mỗi	m o j ˧˨
mộ	m o w ˨˩ ʔ
mộc	m ə w k͡p̚ ˨˩ ʔ
mộng	m ə w ŋ͡m ˨˩ ʔ
một	m o k̚ ˨˩ ʔ
mớ	m əː ˨˩˦
mới	m əː j ˨˩˦
mớm	m əː m ˦˧˥
mờ	m əː ˦˩
mời	m əː j ˦˩
mở	m əː ˧˨
mỡ	m əː ˧˨
mợ	m əː ˨˩ ʔ
mụ	m ʊ w ˨˩ ʔ
mục	m ʊ w k͡p̚ ˨˩ ʔ
mụn	m u n ˨˩ ʔ
mụp	m u p̚ ˨˩ ʔ
mụt	m ʊ k̚ ˨˩ ʔ
mủ	m ʊ w ˧˨
mủi	m u j ˧˨
mủn	m u n ˧˨
mứa	m ɨ ə ˨˩˦
mức	m ɨ k̚ ˦˧˥
mứt	m ɨ k̚ ˦˧˥
mừng	m ɨ ŋ ˦˩
mửa	m ɨ ə ˧˨
mực	m ɨ k̚ ˨˩ ʔ
n	ʔ ɛ ˧˧ n əː ˦˩
na	n aː ˧˧
nai	n aː j ˧˧
nam	n aː m ˧˧
nan	n aː ŋ ˧˧
nang	n aː ŋ ˧˧
nanh	n ɛ ɲ ˧˧
nao	n aː w ˧˧
napan	n aː ˧˧ p aː ŋ ˧˧
natri	n aː ˧˧ ʈ ɪ j ˧˧
nay	n a j ˧˧
nem	n ɛ m ˧˧
neo	n ɛ w ˧˧
neon	n e j ˧˧ ʔ ə w ŋ͡m ˧˧
neođim	n e j ˧˧ ʔ o w ˧˧ ʔ ɗ i m ˧˧
nga	ŋ aː ˧˧
ngai	ŋ aː j ˧˧
ngan	ŋ aː ŋ ˧˧
ngang	ŋ aː ŋ ˧˧
ngao	ŋ aː w ˧˧
ngay	ŋ a j ˧˧
nghe	ŋ ɛ ˧˧
nghen	ŋ ɛ ŋ ˧˧
nghi	ŋ ɪ j ˧˧
nghiêm	ŋ i ə m ˧˧
nghiên	ŋ i ə ŋ ˧˧
nghiêng	ŋ i ə ŋ ˧˧
nghiến	ŋ i ə ŋ ˦˧˥
nghiền	ŋ i ə ŋ ˦˩
nghiệm	ŋ i ə m ˨˩ ʔ
nghiện	ŋ i ə ŋ ˨˩ ʔ
nghiệp	ŋ i ə p̚ ˨˩ ʔ
nghiệt	ŋ i ə k̚ ˨˩ ʔ
nghèo	ŋ ɛ w ˦˩
nghé	ŋ ɛ ˨˩˦
nghén	ŋ ɛ ŋ ˦˧˥
nghê	ŋ e j ˧˧
nghênh	ŋ e n ˧˧
nghêu	ŋ e w ˧˧
nghìm	ŋ i m ˦˩
nghìn	ŋ i n ˦˩
nghía	ŋ i ə ˨˩˦
nghĩ	ŋ ɪ j ˧˨
nghĩa	ŋ i ə ˧˨
nghẹ	ŋ ɛ ˨˩ ʔ
nghẹn	ŋ ɛ ŋ ˨˩ ʔ
nghẹo	ŋ ɛ w ˨˩ ʔ
nghẹt	ŋ ɛ t̚ ˨˩ ʔ
nghẽn	ŋ ɛ ŋ ˧˨
nghếch	ŋ e t̚ ˦˧˥
nghề	ŋ e j ˦˩
nghệ	ŋ e j ˨˩ ʔ
nghỉ	ŋ ɪ j ˧˨
nghị	ŋ ɪ j ˨˩ ʔ
nghịch	ŋ ɨ t̚ ˨˩ ʔ
nghịt	ŋ i t̚ ˨˩ ʔ
ngoa	ŋ w aː ˧˧
ngoan	ŋ w aː ŋ ˧˧
ngoi	ŋ ɔ j ˧˧
ngon	ŋ ɔ ŋ ˧˧
ngoài	ŋ w aː j ˦˩
ngoái	ŋ w aː j ˨˩˦
ngoáy	ŋ w a j ˨˩˦
ngoé	ŋ w ɛ ˨˩˦
ngoém	ŋ w ɛ m ˦˧˥
ngoại	ŋ w aː j ˨˩ ʔ
ngoạm	ŋ w aː m ˨˩ ʔ
ngoải	ŋ w aː j ˧˨
ngoảnh	ŋ w ɛ ɲ ˧˨
ngoảy	ŋ w a j ˧˨
ngoắc	ŋ w a k̚ ˦˧˥
ngoắt	ŋ w a k̚ ˦˧˥
ngoặc	ŋ w a k̚ ˨˩ ʔ
ngoặt	ŋ w a k̚ ˨˩ ʔ
ngoẹo	ŋ w ɛ w ˨˩ ʔ
ngu	ŋ ʊ w ˧˧
nguy	ŋ w ɪ j ˧˧
nguyên	ŋ w i ə ŋ ˧˧
nguyền	ŋ w i ə ŋ ˦˩
nguyễn	ŋ w i ə ŋ ˧˨
nguyện	ŋ w i ə ŋ ˨˩ ʔ
nguyệt	ŋ w i ə k̚ ˨˩ ʔ
nguôi	ŋ u j ˧˧
nguồn	ŋ u ə ŋ ˦˩
nguội	ŋ u j ˨˩ ʔ
nguỵ	ŋ w ɪ j ˨˩ ʔ
ngà	ŋ aː ˦˩
ngài	ŋ aː j ˦˩
ngàn	ŋ aː ŋ ˦˩
ngành	ŋ ɛ ɲ ˦˩
ngày	ŋ a j ˦˩
ngách	ŋ a t̚ ˦˧˥
ngái	ŋ aː j ˨˩˦
ngám	ŋ aː m ˦˧˥
ngán	ŋ aː ŋ ˦˧˥
ngáo	ŋ aː w ˨˩˦
ngáp	ŋ aː p̚ ˦˧˥
ngát	ŋ aː k̚ ˦˧˥
ngáy	ŋ a j ˨˩˦
ngâm	ŋ ə m ˧˧
ngân	ŋ ə ŋ ˧˧
ngâu	ŋ ə w ˧˧
ngây	ŋ ə j ˧˧
ngã	ŋ aː ˧˨
ngãi	ŋ aː j ˧˨
ngò	ŋ ɔ ˦˩
ngòi	ŋ ɔ j ˦˩
ngó	ŋ ɔ ˨˩˦
ngóc	ŋ a w k͡p̚ ˦˧˥
ngói	ŋ ɔ j ˨˩˦
ngón	ŋ ɔ ŋ ˦˧˥
ngóng	ŋ a w ŋ͡m ˦˧˥
ngót	ŋ ɔ k̚ ˦˧˥
ngô	ŋ o w ˧˧
ngôi	ŋ o j ˧˧
ngôn	ŋ o ŋ ˧˧
ngông	ŋ ə w ŋ͡m ˧˧
ngõ	ŋ ɔ ˧˨
ngõi	ŋ ɔ j ˧˨
ngù	ŋ ʊ w ˦˩
ngùi	ŋ u j ˦˩
ngăm	ŋ a m ˧˧
ngăn	ŋ a ŋ ˧˧
ngũ	ŋ ʊ w ˧˨
ngơi	ŋ əː j ˧˧
ngư	ŋ ɨ ˧˧
ngưng	ŋ ɨ ŋ ˧˧
ngươi	ŋ ɨ j ˧˧
ngước	ŋ ɨ ə k̚ ˦˧˥
người	ŋ ɨ j ˦˩
ngưỡng	ŋ ɨ ə ŋ ˧˨
ngược	ŋ ɨ ə k̚ ˨˩ ʔ
ngượng	ŋ ɨ ə ŋ ˨˩ ʔ
ngại	ŋ aː j ˨˩ ʔ
ngạo	ŋ aː w ˨˩ ʔ
ngạt	ŋ aː k̚ ˨˩ ʔ
ngả	ŋ aː ˧˨
ngấm	ŋ ə m ˦˧˥
ngấn	ŋ ə ŋ ˦˧˥
ngất	ŋ ə k̚ ˦˧˥
ngấy	ŋ ə j ˨˩˦
ngầm	ŋ ə m ˦˩
ngần	ŋ ə ŋ ˦˩
ngầu	ŋ ə w ˦˩
ngẩn	ŋ ə ŋ ˧˨
ngẩng	ŋ ə ŋ ˧˨
ngẫm	ŋ ə m ˧˨
ngậm	ŋ ə m ˨˩ ʔ
ngập	ŋ ə p̚ ˨˩ ʔ
ngậy	ŋ ə j ˨˩ ʔ
ngắm	ŋ a m ˦˧˥
ngắn	ŋ a ŋ ˦˧˥
ngắt	ŋ a k̚ ˦˧˥
ngặt	ŋ a k̚ ˨˩ ʔ
ngọ	ŋ ɔ ˨˩ ʔ
ngọc	ŋ a w k͡p̚ ˨˩ ʔ
ngọn	ŋ ɔ ŋ ˨˩ ʔ
ngọng	ŋ a w ŋ͡m ˨˩ ʔ
ngọt	ŋ ɔ k̚ ˨˩ ʔ
ngỏ	ŋ ɔ ˧˨
ngố	ŋ o w ˨˩˦
ngốc	ŋ ə w k͡p̚ ˦˧˥
ngốn	ŋ o ŋ ˦˧˥
ngồi	ŋ o j ˦˩
ngỗng	ŋ ə w ŋ͡m ˧˨
ngộ	ŋ o w ˨˩ ʔ
ngộp	ŋ o p̚ ˨˩ ʔ
ngột	ŋ o k̚ ˨˩ ʔ
ngớ	ŋ əː ˨˩˦
ngớp	ŋ əː p̚ ˦˧˥
ngớt	ŋ əː k̚ ˦˧˥
ngờ	ŋ əː ˦˩
ngời	ŋ əː j ˦˩
ngỡ	ŋ əː ˧˨
ngợi	ŋ əː j ˨˩ ʔ
ngợm	ŋ əː m ˨˩ ʔ
ngợp	ŋ əː p̚ ˨˩ ʔ
ngụ	ŋ ʊ w ˨˩ ʔ
ngục	ŋ ʊ w k͡p̚ ˨˩ ʔ
ngụm	ŋ u m ˨˩ ʔ
ngụp	ŋ u p̚ ˨˩ ʔ
ngủ	ŋ ʊ w ˧˨
ngủm	ŋ u m ˧˨
ngứa	ŋ ɨ ə ˨˩˦
ngừa	ŋ ɨ ə ˦˩
ngừng	ŋ ɨ ŋ ˦˩
ngửa	ŋ ɨ ə ˧˨
ngửi	ŋ ɨ j ˧˨
ngữ	ŋ ɨ ˧˨
ngự	ŋ ɨ ˨˩ ʔ
ngựa	ŋ ɨ ə ˨˩ ʔ
ngực	ŋ ɨ k̚ ˨˩ ʔ
nha	ɲ aː ˧˧
nhai	ɲ aː j ˧˧
nhang	ɲ aː ŋ ˧˧
nhanh	ɲ ɛ ɲ ˧˧
nhau	ɲ a w ˧˧
nhe	ɲ ɛ ˧˧
nheo	ɲ ɛ w ˧˧
nhi	ɲ ɪ j ˧˧
nhiêu	ɲ i w ˧˧
nhiếc	ɲ i ə k̚ ˦˧˥
nhiều	ɲ i w ˦˩
nhiễm	ɲ i ə m ˧˨
nhiễu	ɲ i w ˧˨
nhiệt	ɲ i ə k̚ ˨˩ ʔ
nho	ɲ ɔ ˧˧
nhoi	ɲ ɔ j ˧˧
nhoà	ɲ w aː ˦˩
nhoáng	ɲ w aː ŋ ˦˧˥
nhoẻn	ɲ w ɛ ŋ ˧˨
nhu	ɲ ʊ w ˧˧
nhung	ɲ ʊ w ŋ͡m ˧˧
nhuyễn	ɲ w i ə ŋ ˧˨
nhuốm	ɲ u ə m ˦˧˥
nhuộm	ɲ u ə m ˨˩ ʔ
nhuỵ	ɲ w ɪ j ˨˩ ʔ
nhà	ɲ aː ˦˩
nhài	ɲ aː j ˦˩
nhàm	ɲ aː m ˦˩
nhàn	ɲ aː ŋ ˦˩
nhào	ɲ aː w ˦˩
nhàu	ɲ a w ˦˩
nhá	ɲ aː ˨˩˦
nhác	ɲ aː k̚ ˦˧˥
nhách	ɲ a t̚ ˦˧˥
nhái	ɲ aː j ˨˩˦
nhám	ɲ aː m ˦˧˥
nhánh	ɲ ɛ ɲ ˦˧˥
nháo	ɲ aː w ˨˩˦
nháp	ɲ aː p̚ ˦˧˥
nhát	ɲ aː k̚ ˦˧˥
nháy	ɲ a j ˨˩˦
nhâm	ɲ ə m ˧˧
nhân	ɲ ə ŋ ˧˧
nhây	ɲ ə j ˧˧
nhã	ɲ aː ˧˨
nhãn	ɲ aː ŋ ˧˨
nhãng	ɲ aː ŋ ˧˨
nhão	ɲ aː w ˧˨
nhè	ɲ ɛ ˦˩
nhé	ɲ ɛ ˨˩˦
nhéo	ɲ ɛ w ˨˩˦
nhép	ɲ ɛ p̚ ˦˧˥
nhét	ɲ ɛ t̚ ˦˧˥
nhì	ɲ ɪ j ˦˩
nhìn	ɲ i n ˦˩
nhí	ɲ ɪ j ˨˩˦
nhích	ɲ ɨ t̚ ˦˧˥
nhím	ɲ i m ˦˧˥
nhíp	ɲ i p̚ ˦˧˥
nhíu	ɲ i w ˨˩˦
nhòm	ɲ ɔ m ˦˩
nhóc	ɲ a w k͡p̚ ˦˧˥
nhói	ɲ ɔ j ˨˩˦
nhóm	ɲ ɔ m ˦˧˥
nhón	ɲ ɔ ŋ ˦˧˥
nhót	ɲ ɔ k̚ ˦˧˥
nhô	ɲ o w ˧˧
nhôm	ɲ o m ˧˧
nhông	ɲ ə w ŋ͡m ˧˧
nhôông	ɲ o ŋ ˧˧
nhú	ɲ ʊ w ˨˩˦
nhúm	ɲ u m ˦˧˥
nhún	ɲ u n ˦˧˥
nhúng	ɲ ʊ w ŋ͡m ˦˧˥
nhăm	ɲ a m ˧˧
nhăn	ɲ a ŋ ˧˧
nhĩ	ɲ ɪ j ˧˨
nhũn	ɲ u n ˧˨
nhơ	ɲ əː ˧˧
nhơi	ɲ əː j ˧˧
như	ɲ ɨ ˧˧
nhưng	ɲ ɨ ŋ ˧˧
nhướn	ɲ ɨ ə ŋ ˦˧˥
nhường	ɲ ɨ ə ŋ ˦˩
nhượng	ɲ ɨ ə ŋ ˨˩ ʔ
nhạc	ɲ aː k̚ ˨˩ ʔ
nhại	ɲ aː j ˨˩ ʔ
nhạn	ɲ aː ŋ ˨˩ ʔ
nhạo	ɲ aː w ˨˩ ʔ
nhạt	ɲ aː k̚ ˨˩ ʔ
nhạy	ɲ a j ˨˩ ʔ
nhả	ɲ aː ˧˨
nhảm	ɲ aː m ˧˨
nhảy	ɲ a j ˧˨
nhấc	ɲ ə k̚ ˦˧˥
nhấm	ɲ ə m ˦˧˥
nhấn	ɲ ə ŋ ˦˧˥
nhấp	ɲ ə p̚ ˦˧˥
nhất	ɲ ə k̚ ˦˧˥
nhầm	ɲ ə m ˦˩
nhầy	ɲ ə j ˦˩
nhẩm	ɲ ə m ˧˨
nhẫn	ɲ ə ŋ ˧˨
nhận	ɲ ə ŋ ˨˩ ʔ
nhập	ɲ ə p̚ ˨˩ ʔ
nhật	ɲ ə k̚ ˨˩ ʔ
nhậu	ɲ ə w ˨˩ ʔ
nhắc	ɲ a k̚ ˦˧˥
nhắm	ɲ a m ˦˧˥
nhắn	ɲ a ŋ ˦˧˥
nhắt	ɲ a k̚ ˦˧˥
nhằm	ɲ a m ˦˩
nhằn	ɲ a ŋ ˦˩
nhẵn	ɲ a ŋ ˧˨
nhặng	ɲ a ŋ ˨˩ ʔ
nhặt	ɲ a k̚ ˨˩ ʔ
nhẹ	ɲ ɛ ˨˩ ʔ
nhếch	ɲ e t̚ ˦˧˥
nhể	ɲ e j ˧˨
nhện	ɲ e n ˨˩ ʔ
nhỉ	ɲ ɪ j ˧˨
nhỉnh	ɲ ɨ n ˧˨
nhị	ɲ ɪ j ˨˩ ʔ
nhịn	ɲ i n ˨˩ ʔ
nhịp	ɲ i p̚ ˨˩ ʔ
nhọ	ɲ ɔ ˨˩ ʔ
nhọc	ɲ a w k͡p̚ ˨˩ ʔ
nhọn	ɲ ɔ ŋ ˨˩ ʔ
nhọt	ɲ ɔ k̚ ˨˩ ʔ
nhỏ	ɲ ɔ ˧˨
nhỏng	ɲ a w ŋ͡m ˧˨
nhốt	ɲ o k̚ ˦˧˥
nhồi	ɲ o j ˦˩
nhổ	ɲ o w ˧˨
nhổm	ɲ o m ˧˨
nhộn	ɲ o ŋ ˨˩ ʔ
nhộng	ɲ ə w ŋ͡m ˨˩ ʔ
nhột	ɲ o k̚ ˨˩ ʔ
nhớ	ɲ əː ˨˩˦
nhớn	ɲ əː ŋ ˦˧˥
nhớp	ɲ əː p̚ ˦˧˥
nhớt	ɲ əː k̚ ˦˧˥
nhờ	ɲ əː ˦˩
nhời	ɲ əː j ˦˩
nhờn	ɲ əː ŋ ˦˩
nhởi	ɲ əː j ˧˨
nhỡ	ɲ əː ˧˨
nhợn	ɲ əː ŋ ˨˩ ʔ
nhục	ɲ ʊ w k͡p̚ ˨˩ ʔ
nhủ	ɲ ʊ w ˧˨
nhủi	ɲ u j ˧˨
nhức	ɲ ɨ k̚ ˦˧˥
nhừ	ɲ ɨ ˦˩
nhử	ɲ ɨ ˧˨
những	ɲ ɨ ŋ ˧˨
nhựa	ɲ ɨ ə ˨˩ ʔ
ni	n ɪ j ˧˧
niken	n ɪ j ˧˧ k ɛ n ˧˧
ninh	n ɨ n ˧˧
niobi	n ɪ j ˧˧ ʔ o w ˧˧ ʔ ɓ ɪ j ˧˧
nitơ	n ɪ j ˧˧ t əː ˧˧
niên	n i ə ŋ ˧˧
niêu	n i w ˧˧
niềm	n i ə m ˦˩
niền	n i ə ŋ ˦˩
niềng	n i ə ŋ ˦˩
niễng	n i ə ŋ ˧˨
niệt	n i ə k̚ ˨˩ ʔ
no	n ɔ ˧˧
nobeli	n o w ˧˧ ʔ ɓ e j ˧˧ l ɪ j ˧˧
noi	n ɔ j ˧˧
nom	n ɔ m ˧˧
non	n ɔ ŋ ˧˧
nong	n a w ŋ͡m ˧˧
noãn	n w aː ŋ ˧˨
nui	n u j ˧˧
nung	n ʊ w ŋ͡m ˧˧
nuy	n w ɪ j ˧˧
nuôi	n u j ˧˧
nuối	n u j ˨˩˦
nuốt	n u ə k̚ ˦˧˥
nuột	n u ə k̚ ˨˩ ʔ
nxb	ɲ aː ˦˩ s w ə k̚ ˦˧˥ ʔ ɓ aː ŋ ˧˨
ny	n ɪ j ˧˧
nài	n aː j ˦˩
nàng	n aː ŋ ˦˩
nào	n aː w ˦˩
này	n a j ˦˩
ná	n aː ˨˩˦
nách	n a t̚ ˦˧˥
nái	n aː j ˨˩˦
nám	n aː m ˦˧˥
nán	n aː ŋ ˦˧˥
náng	n aː ŋ ˦˧˥
nát	n aː k̚ ˦˧˥
náu	n a w ˨˩˦
nâng	n ə ŋ ˧˧
nâu	n ə w ˧˧
nã	n aː ˧˨
não	n aː w ˧˨
nãy	n a j ˧˨
nè	n ɛ ˦˩
né	n ɛ ˨˩˦
ném	n ɛ m ˦˧˥
nén	n ɛ ŋ ˦˧˥
nép	n ɛ p̚ ˦˧˥
nét	n ɛ t̚ ˦˧˥
nê	n e j ˧˧
nêm	n e m ˧˧
nên	n e n ˧˧
nêu	n e w ˧˧
ních	n ɨ t̚ ˦˧˥
nín	n i n ˦˧˥
níu	n i w ˨˩˦
nòi	n ɔ j ˦˩
nòng	n a w ŋ͡m ˦˩
nó	n ɔ ˨˩˦
nóc	n a w k͡p̚ ˦˧˥
nói	n ɔ j ˨˩˦
nón	n ɔ ŋ ˦˧˥
nóng	n a w ŋ͡m ˦˧˥
nôi	n o j ˧˧
nôm	n o m ˧˧
nôn	n o ŋ ˧˧
nông	n ə w ŋ͡m ˧˧
nõ	n ɔ ˧˨
nõn	n ɔ ŋ ˧˨
nùi	n u j ˦˩
nùng	n ʊ w ŋ͡m ˦˩
núc	n ʊ w k͡p̚ ˦˧˥
núi	n u j ˨˩˦
núm	n u m ˦˧˥
núp	n u p̚ ˦˧˥
nút	n ʊ k̚ ˦˧˥
năm	n a m ˧˧
năng	n a ŋ ˧˧
nĩa	n i ə ˧˨
nơ	n əː ˧˧
nơi	n əː j ˧˧
nơtron	n əː ˧˧ ʈ ə w ŋ͡m ˧˧
nương	n ɨ ə ŋ ˧˧
nước	n ɨ ə k̚ ˦˧˥
nướng	n ɨ ə ŋ ˦˧˥
nướu	n ɨ ə w ˨˩˦
nạ	n aː ˨˩ ʔ
nạc	n aː k̚ ˨˩ ʔ
nạm	n aː m ˨˩ ʔ
nạn	n aː ŋ ˨˩ ʔ
nạng	n aː ŋ ˨˩ ʔ
nạo	n aː w ˨˩ ʔ
nạp	n aː p̚ ˨˩ ʔ
nạt	n aː k̚ ˨˩ ʔ
nạy	n a j ˨˩ ʔ
nải	n aː j ˧˨
nản	n aː ŋ ˧˨
nảy	n a j ˧˨
nấc	n ə k̚ ˦˧˥
nấm	n ə m ˦˧˥
nấp	n ə p̚ ˦˧˥
nấu	n ə w ˨˩˦
nấy	n ə j ˨˩˦
nầy	n ə j ˦˩
nẩu	n ə w ˧˨
nẫu	n ə w ˧˨
nậy	n ə j ˨˩ ʔ
nắm	n a m ˦˧˥
nắn	n a ŋ ˦˧˥
nắng	n a ŋ ˦˧˥
nắp	n a p̚ ˦˧˥
nằm	n a m ˦˩
nẳm	n a m ˧˨
nặc	n a k̚ ˨˩ ʔ
nặn	n a ŋ ˨˩ ʔ
nặng	n a ŋ ˨˩ ʔ
nẹp	n ɛ p̚ ˨˩ ʔ
nẻ	n ɛ ˧˨
nẻo	n ɛ w ˧˨
nếm	n e m ˦˧˥
nến	n e n ˦˧˥
nếp	n e p̚ ˦˧˥
nết	n e t̚ ˦˧˥
nếu	n e w ˨˩˦
nền	n e n ˦˩
nể	n e j ˧˨
nệm	n e m ˨˩ ʔ
nện	n e n ˨˩ ʔ
nịch	n ɨ t̚ ˨˩ ʔ
nịnh	n ɨ n ˨˩ ʔ
nịt	n i t̚ ˨˩ ʔ
nọ	n ɔ ˨˩ ʔ
nọc	n a w k͡p̚ ˨˩ ʔ
nọng	n a w ŋ͡m ˨˩ ʔ
nỏ	n ɔ ˧˨
nốc	n ə w k͡p̚ ˦˧˥
nối	n o j ˨˩˦
nốt	n o k̚ ˦˧˥
nồi	n o j ˦˩
nồng	n ə w ŋ͡m ˦˩
nổ	n o w ˧˨
nổi	n o j ˧˨
nỗi	n o j ˧˨
nội	n o j ˨˩ ʔ
nộm	n o m ˨˩ ʔ
nộp	n o p̚ ˨˩ ʔ
nớ	n əː ˨˩˦
nới	n əː j ˨˩˦
nở	n əː ˧˨
nỡ	n əː ˧˨
nợ	n əː ˨˩ ʔ
nụ	n ʊ w ˨˩ ʔ
nứa	n ɨ ə ˨˩˦
nứng	n ɨ ŋ ˦˧˥
nứt	n ɨ k̚ ˦˧˥
nừng	n ɨ ŋ ˦˩
nửa	n ɨ ə ˧˨
nữ	n ɨ ˧˨
nữa	n ɨ ə ˧˨
nực	n ɨ k̚ ˨˩ ʔ
nựng	n ɨ ŋ ˨˩ ʔ
o	ʔ ɔ ˧˧
oai	ʔ w aː j ˧˧
obitan	ʔ ɔ ˧˧ ʔ ɓ ɪ j ˧˧ t aː ŋ ˧˧
oi	ʔ ɔ j ˧˧
om	ʔ ɔ m ˧˧
ong	ʔ a w ŋ͡m ˧˧
osimi	ʔ o w ˧˧ s ɪ j ˧˧ m ɪ j ˧˧
oxi	ʔ o w ˧˧ s ɪ j ˧˧
oà	ʔ w aː ˦˩
oách	ʔ w a t̚ ˦˧˥
oóc	ʔ ɔ k̚ ˦˧˥
oải	ʔ w aː j ˧˨
oắt	ʔ w a k̚ ˦˧˥
oằn	ʔ w a ŋ ˦˩
oẳng	ʔ w a ŋ ˧˨
oặt	ʔ w a k̚ ˨˩ ʔ
p	p e j ˧˧
palađi	p aː ˧˧ l aː ˧˧ ʔ ɗ ɪ j ˧˧
panh	p ɛ ɲ ˧˧
pao	p aː w ˧˧
parabol	p aː ˧˧ ɹ aː ˧˧ ʔ ɓ ɔ ŋ ˧˧
patriciô	p aː ˧˧ ʈ ɪ j ˧˧ s ɪ j ˧˧ ʔ o w ˧˧
pha	f aː ˧˧
phai	f aː j ˧˧
phan	f aː ŋ ˧˧
phang	f aː ŋ ˧˧
phanh	f ɛ ɲ ˧˧
phanxicô	f aː ŋ ˧˧ s ɪ j ˧˧ k o w ˧˧
phao	f aː w ˧˧
phaolô	f aː w ˧˧ l o w ˧˧
phau	f a w ˧˧
phe	f ɛ ˧˧
phen	f ɛ ŋ ˧˧
phi	f ɪ j ˧˧
philípphê	f ɪ j ˧˧ l i p̚ ˦˧˥ f e j ˧˧
phim	f i m ˧˧
phin	f i n ˧˧
phiên	f i ə ŋ ˧˧
phiếm	f i ə m ˦˧˥
phiến	f i ə ŋ ˦˧˥
phiếu	f i w ˨˩˦
phiền	f i ə ŋ ˦˩
pho	f ɔ ˧˧
phoi	f ɔ j ˧˧
phong	f a w ŋ͡m ˧˧
photpho	f o k̚ ˦˧˥ f ɔ ˧˧
phun	f u n ˧˧
phuy	f w ɪ j ˧˧
phà	f aː ˦˩
phàm	f aː m ˦˩
phá	f aː ˨˩˦
phác	f aː k̚ ˦˧˥
phách	f a t̚ ˦˧˥
phái	f aː j ˨˩˦
pháo	f aː w ˨˩˦
pháp	f aː p̚ ˦˧˥
phát	f aː k̚ ˦˧˥
phân	f ə ŋ ˧˧
phây	f ə j ˧˧
phè	f ɛ ˦˩
phèn	f ɛ ŋ ˦˩
phèo	f ɛ w ˦˩
phép	f ɛ p̚ ˦˧˥
phê	f e j ˧˧
phên	f e n ˧˧
phêrô	f e j ˧˧ ʐ o w ˧˧
phình	f ɨ n ˦˩
phí	f ɪ j ˨˩˦
phía	f i ə ˨˩˦
phích	f ɨ t̚ ˦˧˥
phím	f i m ˦˧˥
phò	f ɔ ˦˩
phòi	f ɔ j ˦˩
phòng	f a w ŋ͡m ˦˩
phó	f ɔ ˨˩˦
phóng	f a w ŋ͡m ˦˧˥
phôi	f o j ˧˧
phông	f ə w ŋ͡m ˧˧
phù	f ʊ w ˦˩
phùn	f u n ˦˩
phùng	f ʊ w ŋ͡m ˦˩
phú	f ʊ w ˨˩˦
phúc	f ʊ w k͡p̚ ˦˧˥
phút	f ʊ k̚ ˦˧˥
phũ	f ʊ w ˧˨
phơi	f əː j ˧˧
phương	f ɨ ə ŋ ˧˧
phước	f ɨ ə k̚ ˦˧˥
phường	f ɨ ə ŋ ˦˩
phượng	f ɨ ə ŋ ˨˩ ʔ
phượt	f ɨ ə k̚ ˨˩ ʔ
phạm	f aː m ˨˩ ʔ
phạt	f aː k̚ ˨˩ ʔ
phả	f aː ˧˨
phải	f aː j ˧˨
phản	f aː ŋ ˧˨
phấn	f ə ŋ ˦˧˥
phất	f ə k̚ ˦˧˥
phần	f ə ŋ ˦˩
phẩm	f ə m ˧˨
phẩy	f ə j ˧˨
phẫu	f ə w ˧˨
phận	f ə ŋ ˨˩ ʔ
phật	f ə k̚ ˨˩ ʔ
phẳng	f a ŋ ˧˨
phế	f e j ˨˩˦
phếch	f e t̚ ˦˧˥
phết	f e t̚ ˦˧˥
phễu	f e w ˧˨
phệ	f e j ˨˩ ʔ
phỉ	f ɪ j ˧˨
phỉnh	f ɨ n ˧˨
phị	f ɪ j ˨˩ ʔ
phịch	f ɨ t̚ ˨˩ ʔ
phọt	f ɔ k̚ ˨˩ ʔ
phỏng	f a w ŋ͡m ˧˨
phố	f o w ˨˩˦
phối	f o j ˨˩˦
phốt	f o k̚ ˦˧˥
phồng	f ə w ŋ͡m ˦˩
phổ	f o w ˧˨
phổi	f o j ˧˨
phới	f əː j ˨˩˦
phớt	f əː k̚ ˦˧˥
phở	f əː ˧˨
phụ	f ʊ w ˨˩ ʔ
phục	f ʊ w k͡p̚ ˨˩ ʔ
phụng	f ʊ w ŋ͡m ˨˩ ʔ
phụt	f ʊ k̚ ˨˩ ʔ
phủ	f ʊ w ˧˨
phủi	f u j ˧˨
pin	p i n ˧˧
piô	p ɪ j ˧˧ ʔ o w ˧˧
platin	p l aː ˧˧ t i n ˧˧
pleiku	p əː ˦˩ l ə j ˧˧ k ʊ w ˧˧
plutoni	p l ʊ w ˧˧ t o w ˧˧ n ɪ j ˧˧
poloni	p o w ˧˧ l o w ˧˧ n ɪ j ˧˧
polyetylen	p ɔ ˧˧ l ɪ j ˧˧ ʔ e j ˧˧ t ɪ j ˧˧ l ɛ ŋ ˧˧
prazeođim	p ɹ aː ˧˧ z ɛ w ˧˧ ʔ ɗ i m ˧˧
prometi	p ɹ o w ˧˧ m e j ˧˧ t ɪ j ˧˧
protactini	ʔ ʊ w ˧˧ ɹ aː ˧˧ n ɪ j ˧˧
prôton	p ɹ o w ˧˧ t ə w ŋ͡m ˧˧
pê	p e j ˧˧
pích	p ɨ t̚ ˦˧˥
píp	p i p̚ ˦˧˥
pô	p o w ˧˧
q	k ʊ w ˧˧
qua	k w aː ˧˧
quai	k w aː j ˧˧
quan	k w aː ŋ ˧˧
quang	k w aː ŋ ˧˧
quanh	k w ɛ ɲ ˧˧
quay	k w a j ˧˧
que	k w ɛ ˧˧
quen	k w ɛ ŋ ˧˧
quy	k w ɪ j ˧˧
quyên	k w i ə ŋ ˧˧
quyến	k w i ə ŋ ˦˧˥
quyết	k w i ə k̚ ˦˧˥
quyền	k w i ə ŋ ˦˩
quyển	k w i ə ŋ ˧˨
quyện	k w i ə ŋ ˨˩ ʔ
quyệt	k w i ə k̚ ˨˩ ʔ
quà	k w aː ˦˩
quàng	k w aː ŋ ˦˩
quành	k w ɛ ɲ ˦˩
quào	k w aː w ˦˩
quá	k w aː ˨˩˦
quách	k w a t̚ ˦˧˥
quái	k w aː j ˨˩˦
quán	k w aː ŋ ˦˧˥
quát	k w aː k̚ ˦˧˥
quân	k w ə ŋ ˧˧
quây	k w ə j ˧˧
quãng	k w aː ŋ ˧˨
què	k w ɛ ˦˩
qué	k w ɛ ˨˩˦
quét	k w ɛ t̚ ˦˧˥
quê	k w e j ˧˧
quên	k w e n ˧˧
quít	k w i t̚ ˦˧˥
quý	k w ɪ j ˨˩˦
quýnh	k w ɨ n ˦˧˥
quýt	k w ɨ t̚ ˦˧˥
quýu	k w i w ˨˩˦
quăn	k w a ŋ ˧˧
quăng	k w a ŋ ˧˧
quơ	k w əː ˧˧
quạ	k w aː ˨˩ ʔ
quạc	k w aː k̚ ˨˩ ʔ
quạnh	k w ɛ ɲ ˨˩ ʔ
quạt	k w aː k̚ ˨˩ ʔ
quạu	k w a w ˨˩ ʔ
quả	k w aː ˧˨
quản	k w aː ŋ ˧˨
quảng	k w aː ŋ ˧˨
quảy	k w a j ˧˨
quấc	k w ə k̚ ˦˧˥
quấn	k w ə ŋ ˦˧˥
quất	k w ə k̚ ˦˧˥
quấy	k w ə j ˨˩˦
quần	k w ə ŋ ˦˩
quầy	k w ə j ˦˩
quẩn	k w ə ŋ ˧˨
quẩy	k w ə j ˧˨
quẫy	k w ə j ˧˨
quận	k w ə ŋ ˨˩ ʔ
quật	k w ə k̚ ˨˩ ʔ
quậy	k w ə j ˨˩ ʔ
quắt	k w a k̚ ˦˧˥
quặm	k w a m ˨˩ ʔ
quặng	k w a ŋ ˨˩ ʔ
quặt	k w a k̚ ˨˩ ʔ
quẹo	k w ɛ w ˨˩ ʔ
quẹt	k w ɛ t̚ ˨˩ ʔ
quẻ	k w ɛ ˧˨
quế	k w e j ˨˩˦
quết	k w e t̚ ˦˧˥
quốc	k u ə k̚ ˦˧˥
quở	k w əː ˧˨
quỳ	k w ɪ j ˦˩
quỳnh	k w ɨ n ˦˩
quỵ	k w ɪ j ˨˩ ʔ
quỵt	k w ɨ t̚ ˨˩ ʔ
quỷ	k w ɪ j ˧˨
quỹ	k w ɪ j ˧˨
r	ʔ ɛ ˧˧ ʐ əː ˦˩
ra	ɹ aː ˧˧
ra	ʐ aː ˧˧
ram	ʐ aː m ˧˧
ran	ʐ aː ŋ ˧˧
rang	ʐ aː ŋ ˧˧
rao	ʐ aː w ˧˧
rau	ʐ a w ˧˧
rađi	ɹ aː ˧˧ ʔ ɗ ɪ j ˧˧
rađon	ɹ aː ˧˧ ʔ ɗ ə w ŋ͡m ˧˧
ren	ʐ ɛ ŋ ˧˧
reni	ɹ e j ˧˧ n ɪ j ˧˧
ri	ʐ ɪ j ˧˧
ria	ʐ i ə ˧˧
rinh	ʐ ɨ n ˧˧
riêng	ʐ i ə ŋ ˧˧
riêu	ʐ i w ˧˧
riết	ʐ i ə k̚ ˦˧˥
riềng	ʐ i ə ŋ ˦˩
riệu	ʐ i w ˨˩ ʔ
roi	ʐ ɔ j ˧˧
rong	ʐ a w ŋ͡m ˧˧
rođi	ɹ o w ˧˧ ʔ ɗ ɪ j ˧˧
ru	ʐ ʊ w ˧˧
rubiđi	ɹ ʊ w ˧˧ ʔ ɓ ɪ j ˧˧ ʔ ɗ ɪ j ˧˧
rum	ʐ u m ˧˧
run	ʐ u n ˧˧
rung	ʐ ʊ w ŋ͡m ˧˧
ruteni	ɹ ʊ w ˧˧ t e j ˧˧ n ɪ j ˧˧
ruốc	ʐ u ə k̚ ˦˧˥
ruồi	ʐ u j ˦˩
ruộng	ʐ u ə ŋ ˨˩ ʔ
ruột	ʐ u ə k̚ ˨˩ ʔ
rà	ʐ aː ˦˩
ràn	ʐ aː ŋ ˦˩
ràng	ʐ aː ŋ ˦˩
rành	ʐ ɛ ɲ ˦˩
rào	ʐ aː w ˦˩
rày	ʐ a j ˦˩
rá	ʐ aː ˨˩˦
rác	ʐ aː k̚ ˦˧˥
rách	ʐ a t̚ ˦˧˥
rái	ʐ aː j ˨˩˦
rán	ʐ aː ŋ ˦˧˥
ráng	ʐ aː ŋ ˦˧˥
ráo	ʐ aː w ˨˩˦
ráp	ʐ aː p̚ ˦˧˥
rát	ʐ aː k̚ ˦˧˥
ráy	ʐ a j ˨˩˦
râm	ʐ ə m ˧˧
râu	ʐ ə w ˧˧
rây	ʐ ə j ˧˧
rã	ʐ aː ˧˨
rãnh	ʐ ɛ ɲ ˧˨
rèm	ʐ ɛ m ˦˩
rèn	ʐ ɛ ŋ ˦˩
ré	ʐ ɛ ˨˩˦
rén	ʐ ɛ ŋ ˦˧˥
réo	ʐ ɛ w ˨˩˦
rét	ʐ ɛ t̚ ˦˧˥
rê	ʐ e j ˧˧
rên	ʐ e n ˧˧
rêu	ʐ e w ˧˧
rìa	ʐ i ə ˦˩
rình	ʐ ɨ n ˦˩
rìu	ʐ i w ˦˩
rích	ʐ ɨ t̚ ˦˧˥
rít	ʐ i t̚ ˦˧˥
ríu	ʐ i w ˨˩˦
rò	ʐ ɔ ˦˩
ròm	ʐ ɔ m ˦˩
ròng	ʐ a w ŋ͡m ˦˩
rót	ʐ ɔ k̚ ˦˧˥
rô	ʐ o w ˧˧
rông	ʐ ə w ŋ͡m ˧˧
rõ	ʐ ɔ ˧˨
rùa	ʐ u ə ˦˩
rùm	ʐ u m ˦˩
rùn	ʐ u n ˦˩
rùng	ʐ ʊ w ŋ͡m ˦˩
rú	ʐ ʊ w ˨˩˦
rúc	ʐ ʊ w k͡p̚ ˦˧˥
rún	ʐ u n ˦˧˥
rút	ʐ ʊ k̚ ˦˧˥
răn	ʐ a ŋ ˧˧
răng	ʐ a ŋ ˧˧
rũ	ʐ ʊ w ˧˨
rũa	ʐ u ə ˧˨
rơ	ɹ əː ˧˧
rơi	ʐ əː j ˧˧
rơm	ʐ əː m ˧˧
rơzơfođi	ɹ əː ˧˧ z əː ˧˧ f ɔ ˧˧ ʔ ɗ ɪ j ˧˧
rươi	ʐ ɨ j ˧˧
rương	ʐ ɨ ə ŋ ˧˧
rước	ʐ ɨ ə k̚ ˦˧˥
rưới	ʐ ɨ j ˨˩˦
rướm	ʐ ɨ ə m ˦˧˥
rường	ʐ ɨ ə ŋ ˦˩
rưởi	ʐ ɨ j ˧˨
rưỡi	ʐ ɨ j ˧˨
rượt	ʐ ɨ ə k̚ ˨˩ ʔ
rượu	ʐ ɨ ə w ˨˩ ʔ
rạ	ʐ aː ˨˩ ʔ
rạc	ʐ aː k̚ ˨˩ ʔ
rạch	ʐ a t̚ ˨˩ ʔ
rạn	ʐ aː ŋ ˨˩ ʔ
rạng	ʐ aː ŋ ˨˩ ʔ
rạp	ʐ aː p̚ ˨˩ ʔ
rải	ʐ aː j ˧˨
rảnh	ʐ ɛ ɲ ˧˨
rảy	ʐ a j ˧˨
rấm	ʐ ə m ˦˧˥
rấp	ʐ ə p̚ ˦˧˥
rất	ʐ ə k̚ ˦˧˥
rầm	ʐ ə m ˦˩
rầu	ʐ ə w ˦˩
rầy	ʐ ə j ˦˩
rẩy	ʐ ə j ˧˨
rẫy	ʐ ə j ˧˨
rậm	ʐ ə m ˨˩ ʔ
rận	ʐ ə ŋ ˨˩ ʔ
rập	ʐ ə p̚ ˨˩ ʔ
rắc	ʐ a k̚ ˦˧˥
rắm	ʐ a m ˦˧˥
rắn	ʐ a ŋ ˦˧˥
rắp	ʐ a p̚ ˦˧˥
rằm	ʐ a m ˦˩
rằn	ʐ a ŋ ˦˩
rằng	ʐ a ŋ ˦˩
rặn	ʐ a ŋ ˨˩ ʔ
rặng	ʐ a ŋ ˨˩ ʔ
rẻ	ʐ ɛ ˧˨
rẻo	ʐ ɛ w ˧˨
rẽ	ʐ ɛ ˧˨
rế	ʐ e j ˨˩˦
rếch	ʐ e t̚ ˦˧˥
rết	ʐ e t̚ ˦˧˥
rề	ʐ e j ˦˩
rền	ʐ e n ˦˩
rể	ʐ e j ˧˨
rễ	ʐ e j ˧˨
rệ	ʐ e j ˨˩ ʔ
rệp	ʐ e p̚ ˨˩ ʔ
rỉ	ʐ ɪ j ˧˨
rỉa	ʐ i ə ˧˨
rọ	ʐ ɔ ˨˩ ʔ
rọc	ʐ a w k͡p̚ ˨˩ ʔ
rọi	ʐ ɔ j ˨˩ ʔ
rối	ʐ o j ˨˩˦
rốn	ʐ o ŋ ˦˧˥
rống	ʐ ə w ŋ͡m ˦˧˥
rốt	ʐ o k̚ ˦˧˥
rồ	ʐ o w ˦˩
rồi	ʐ o j ˦˩
rồng	ʐ ə w ŋ͡m ˦˩
rổ	ʐ o w ˧˨
rỗi	ʐ o j ˧˨
rỗng	ʐ ə w ŋ͡m ˧˨
rộ	ʐ o w ˨˩ ʔ
rộn	ʐ o ŋ ˨˩ ʔ
rộng	ʐ ə w ŋ͡m ˨˩ ʔ
rớ	ʐ əː ˨˩˦
rớm	ʐ əː m ˦˧˥
rớt	ʐ əː k̚ ˦˧˥
rờ	ʐ əː ˦˩
rời	ʐ əː j ˦˩
rởm	ʐ əː m ˧˨
rỡ	ʐ əː ˧˨
rợ	ʐ əː ˨˩ ʔ
rợn	ʐ əː ŋ ˨˩ ʔ
rợp	ʐ əː p̚ ˨˩ ʔ
rục	ʐ ʊ w k͡p̚ ˨˩ ʔ
rụng	ʐ ʊ w ŋ͡m ˨˩ ʔ
rụt	ʐ ʊ k̚ ˨˩ ʔ
rủ	ʐ ʊ w ˧˨
rủa	ʐ u ə ˧˨
rủi	ʐ u j ˧˨
rứa	ʐ ɨ ə ˨˩˦
rứt	ʐ ɨ k̚ ˦˧˥
rừng	ʐ ɨ ŋ ˦˩
rử	ʐ ɨ ˧˨
rửa	ʐ ɨ ə ˧˨
rữa	ʐ ɨ ə ˧˨
rựa	ʐ ɨ ə ˨˩ ʔ
rực	ʐ ɨ k̚ ˨˩ ʔ
s	ʔ ɛ t̚ ˦˧˥ ʂ ɪ j ˦˩
sa	ʂ aː ˧˧
sai	ʂ aː j ˧˧
sam	ʂ aː m ˧˧
samari	s aː ˧˧ m aː ˧˧ ɹ ɪ j ˧˧
san	ʂ aː ŋ ˧˧
sang	ʂ aː ŋ ˧˧
sanh	ʂ ɛ ɲ ˧˧
sao	ʂ aː w ˧˧
sau	ʂ a w ˧˧
say	ʂ a j ˧˧
scanđi	s k aː ŋ ˧˧ ʔ ɗ ɪ j ˧˧
selen	s e j ˧˧ l ɛ ŋ ˧˧
sen	ʂ ɛ ŋ ˧˧
seo	ʂ ɛ w ˧˧
si	ʂ ɪ j ˧˧
sida	s ɪ j ˧˧ ʔ ɗ aː ˧˧
silic	s ɪ j ˧˧ l ï k̟̚ ˦˧˥
sim	ʂ i m ˧˧
simon	ʂ ɪ j ˧˧ m ɔ ŋ ˧˧
sin	ʂ i n ˧˧
sinh	ʂ ɨ n ˧˧
siêu	ʂ i w ˧˧
siết	ʂ i ə k̚ ˦˧˥
so	ʂ ɔ ˧˧
soi	ʂ ɔ j ˧˧
son	ʂ ɔ ŋ ˧˧
song	ʂ a w ŋ͡m ˧˧
soát	ʂ w aː k̚ ˦˧˥
soóc	ʂ ɔ k̚ ˦˧˥
soạn	ʂ w aː ŋ ˨˩ ʔ
soọc	ʂ ɔ k̚ ˨˩ ʔ
spam	s p a m ˧˧
stibi	s t ɪ j ˧˧ ʔ ɓ ɪ j ˧˧
stronti	ʂ t ɹ ɔ ŋ ˧˧ t ɪ j ˧˧
stêphanô	s t e j ˧˧ f aː ŋ ˧˧ n o w ˧˧
sui	ʂ u j ˧˧
sun	ʂ u n ˧˧
sung	ʂ ʊ w ŋ͡m ˧˧
suy	ʂ w ɪ j ˧˧
suyễn	ʂ w i ə ŋ ˧˨
suôn	ʂ u ə ŋ ˧˧
suýt	ʂ w ɨ t̚ ˦˧˥
suất	ʂ w ə k̚ ˦˧˥
suối	ʂ u j ˨˩˦
suốt	ʂ u ə k̚ ˦˧˥
suỵt	ʂ w ɨ t̚ ˨˩ ʔ
sylvestrô	s i w ˧˧ v ɛ t̚ ˦˧˥ s t ɹ o w ˧˧
sài	ʂ aː j ˦˩
sàn	ʂ aː ŋ ˦˩
sàng	ʂ aː ŋ ˦˩
sành	ʂ ɛ ɲ ˦˩
sào	ʂ aː w ˦˩
sá	ʂ aː ˨˩˦
sách	ʂ a t̚ ˦˧˥
sái	ʂ aː j ˨˩˦
sán	ʂ aː ŋ ˦˧˥
sáng	ʂ aː ŋ ˦˧˥
sánh	ʂ ɛ ɲ ˦˧˥
sáo	ʂ aː w ˨˩˦
sáp	ʂ aː p̚ ˦˧˥
sát	ʂ aː k̚ ˦˧˥
sáu	ʂ a w ˨˩˦
sâm	ʂ ə m ˧˧
sân	ʂ ə ŋ ˧˧
sâu	ʂ ə w ˧˧
sãi	ʂ aː j ˧˨
séc	ʂ ɛ k̚ ˦˧˥
sét	ʂ ɛ t̚ ˦˧˥
sên	ʂ e n ˧˧
sênh	ʂ e n ˧˧
sêvêrinô	s e j ˧˧ v e j ˧˧ ʐ ɪ j ˧˧ n o w ˧˧
sình	ʂ ɨ n ˦˩
sính	ʂ ɨ n ˦˧˥
síp	ʂ i p̚ ˦˧˥
sít	ʂ i t̚ ˦˧˥
sò	ʂ ɔ ˦˩
sòng	ʂ a w ŋ͡m ˦˩
sóc	ʂ a w k͡p̚ ˦˧˥
sói	ʂ ɔ j ˨˩˦
sóng	ʂ a w ŋ͡m ˦˧˥
sót	ʂ ɔ k̚ ˦˧˥
sô	ʂ o w ˧˧
sôi	ʂ o j ˧˧
sông	ʂ ə w ŋ͡m ˧˧
sõi	ʂ ɔ j ˧˨
sùng	ʂ ʊ w ŋ͡m ˦˩
sú	ʂ ʊ w ˨˩˦
súc	ʂ ʊ w k͡p̚ ˦˧˥
sún	ʂ u n ˦˧˥
súng	ʂ ʊ w ŋ͡m ˦˧˥
sút	ʂ ʊ k̚ ˦˧˥
săm	ʂ a m ˧˧
săn	ʂ a ŋ ˧˧
sĩ	ʂ ɪ j ˧˨
sũng	ʂ ʊ w ŋ͡m ˧˨
sơ	ʂ əː ˧˧
sơn	ʂ əː ŋ ˧˧
sư	ʂ ɨ ˧˧
sưa	ʂ ɨ ə ˧˧
sưng	ʂ ɨ ŋ ˧˧
sưu	ʂ ɨ w ˧˧
sương	ʂ ɨ ə ŋ ˧˧
sướng	ʂ ɨ ə ŋ ˦˧˥
sườn	ʂ ɨ ə ŋ ˦˩
sưởi	ʂ ɨ j ˧˨
sượng	ʂ ɨ ə ŋ ˨˩ ʔ
sạc	ʂ aː k̚ ˨˩ ʔ
sạch	ʂ a t̚ ˨˩ ʔ
sạn	ʂ aː ŋ ˨˩ ʔ
sạt	ʂ aː k̚ ˨˩ ʔ
sả	ʂ aː ˧˨
sải	ʂ aː j ˧˨
sản	ʂ aː ŋ ˧˨
sảo	ʂ aː w ˧˨
sấm	ʂ ə m ˦˧˥
sấp	ʂ ə p̚ ˦˧˥
sấu	ʂ ə w ˨˩˦
sấy	ʂ ə j ˨˩˦
sầu	ʂ ə w ˦˩
sầy	ʂ ə j ˦˩
sẩy	ʂ ə j ˧˨
sẫm	ʂ ə m ˧˨
sậm	ʂ ə m ˨˩ ʔ
sập	ʂ ə p̚ ˨˩ ʔ
sậy	ʂ ə j ˨˩ ʔ
sắc	ʂ a k̚ ˦˧˥
sắm	ʂ a m ˦˧˥
sắn	ʂ a ŋ ˦˧˥
sắp	ʂ a p̚ ˦˧˥
sắt	ʂ a k̚ ˦˧˥
sẵn	ʂ a ŋ ˧˨
sặc	ʂ a k̚ ˨˩ ʔ
sẹo	ʂ ɛ w ˨˩ ʔ
sẻ	ʂ ɛ ˧˨
sẽ	ʂ ɛ ˧˨
sến	ʂ e n ˦˧˥
sếp	ʂ e p̚ ˦˧˥
sếu	ʂ e w ˨˩˦
sệt	ʂ e t̚ ˨˩ ʔ
sỉ	ʂ ɪ j ˧˨
sỉa	ʂ i ə ˧˨
sọ	ʂ ɔ ˨˩ ʔ
sọc	ʂ a w k͡p̚ ˨˩ ʔ
sọt	ʂ ɔ k̚ ˨˩ ʔ
sỏ	ʂ ɔ ˧˨
sỏi	ʂ ɔ j ˧˨
số	ʂ o w ˨˩˦
sốc	ʂ ə w k͡p̚ ˦˧˥
sống	ʂ ə w ŋ͡m ˦˧˥
sốt	ʂ o k̚ ˦˧˥
sồi	ʂ o j ˦˩
sổ	ʂ o w ˧˨
sổng	ʂ ə w ŋ͡m ˧˨
sớm	ʂ əː m ˦˧˥
sớt	ʂ əː k̚ ˦˧˥
sờ	ʂ əː ˦˩
sờn	ʂ əː ŋ ˦˩
sở	ʂ əː ˧˨
sởi	ʂ əː j ˧˨
sởn	ʂ əː ŋ ˧˨
sợ	ʂ əː ˨˩ ʔ
sợi	ʂ əː j ˨˩ ʔ
sục	ʂ ʊ w k͡p̚ ˨˩ ʔ
sụn	ʂ u n ˨˩ ʔ
sụp	ʂ u p̚ ˨˩ ʔ
sụt	ʂ ʊ k̚ ˨˩ ʔ
sủa	ʂ u ə ˧˨
sủi	ʂ u j ˧˨
sứ	ʂ ɨ ˨˩˦
sứa	ʂ ɨ ə ˨˩˦
sức	ʂ ɨ k̚ ˦˧˥
sứt	ʂ ɨ k̚ ˦˧˥
sừng	ʂ ɨ ŋ ˦˩
sử	ʂ ɨ ˧˨
sửa	ʂ ɨ ə ˧˨
sửu	ʂ ɨ w ˧˨
sữa	ʂ ɨ ə ˧˨
sững	ʂ ɨ ŋ ˧˨
sự	ʂ ɨ ˨˩ ʔ
sực	ʂ ɨ k̚ ˨˩ ʔ
t	t e j ˧˧
ta	t aː ˧˧
tai	t aː j ˧˧
tali	t aː ˧˧ l ɪ j ˧˧
tam	t aː m ˧˧
tan	t aː ŋ ˧˧
tang	t aː ŋ ˧˧
tanh	t ɛ ɲ ˧˧
tantan	t aː n ˧˧ t aː n ˧˧
tao	t aː w ˧˧
tau	t a w ˧˧
tay	t a j ˧˧
tađêô	t aː ˧˧ ʔ ɗ e j ˧˧ ʔ o w ˧˧
tcn	ʈ ɨ ə k̚ ˦˧˥ k ə w ŋ͡m ˧˧ ŋ w i ə ŋ ˧˧
tebi	t ɛ ˧˧ ʔ ɓ ɪ j ˧˧
tecnexi	t ɛ k̚ ˦˧˥ n e j ˧˧ s ɪ j ˧˧
telex	t e j ˧˧ l e t̚ ˦˧˥
telu	t ɛ ˧˧ l ʊ w ˧˧
tem	t ɛ m ˧˧
teo	t ɛ w ˧˧
tgp	t ə w ŋ͡m ˧˨ j aː w ˨˩˦ f ə ŋ ˨˩ ʔ
tha	tʰ aː ˧˧
thai	tʰ aː j ˧˧
tham	tʰ aː m ˧˧
than	tʰ aː ŋ ˧˧
thang	tʰ aː ŋ ˧˧
thanh	tʰ ɛ ɲ ˧˧
thau	tʰ a w ˧˧
thay	tʰ a j ˧˧
thcs	ʈ ʊ w ŋ͡m ˧˧ h a w k͡p̚ ˨˩ ʔ k əː ˧˧ ʂ əː ˧˨
the	tʰ ɛ ˧˧
then	tʰ ɛ ŋ ˧˧
theo	tʰ ɛ w ˧˧
thi	tʰ ɪ j ˧˧
thinh	tʰ ɨ n ˧˧
thiu	tʰ i w ˧˧
thiên	tʰ i ə ŋ ˧˧
thiêng	tʰ i ə ŋ ˧˧
thiêu	tʰ i w ˧˧
thiếc	tʰ i ə k̚ ˦˧˥
thiến	tʰ i ə ŋ ˦˧˥
thiếp	tʰ i ə p̚ ˦˧˥
thiết	tʰ i ə k̚ ˦˧˥
thiếu	tʰ i w ˨˩˦
thiền	tʰ i ə ŋ ˦˩
thiện	tʰ i ə ŋ ˨˩ ʔ
thiệt	tʰ i ə k̚ ˨˩ ʔ
thoa	tʰ w aː ˧˧
thoi	tʰ ɔ j ˧˧
thon	tʰ ɔ ŋ ˧˧
thori	tʰ ɔ ˧˧ ɹ ɪ j ˧˧
thoáng	tʰ w aː ŋ ˦˧˥
thoát	tʰ w aː k̚ ˦˧˥
thoại	tʰ w aː j ˨˩ ʔ
thoạt	tʰ w aː k̚ ˨˩ ʔ
thoả	tʰ w aː ˧˨
thoải	tʰ w aː j ˧˨
thoảng	tʰ w aː ŋ ˧˨
thpt	ʈ ʊ w ŋ͡m ˧˧ h a w k͡p̚ ˨˩ ʔ f o w ˧˨ tʰ ə w ŋ͡m ˧˧
thu	tʰ ʊ w ˧˧
thua	tʰ u ə ˧˧
thui	tʰ u j ˧˧
thun	tʰ u n ˧˧
thung	tʰ ʊ w ŋ͡m ˧˧
thuyết	tʰ w i ə k̚ ˦˧˥
thuyền	tʰ w i ə ŋ ˦˩
thuê	tʰ w e j ˧˧
thuôn	tʰ u ə ŋ ˧˧
thuý	tʰ w ɪ j ˨˩˦
thuần	tʰ w ə ŋ ˦˩
thuận	tʰ w ə ŋ ˨˩ ʔ
thuật	tʰ w ə k̚ ˨˩ ʔ
thuế	tʰ w e j ˨˩˦
thuốc	tʰ u ə k̚ ˦˧˥
thuổng	tʰ u ə ŋ ˧˨
thuộc	tʰ u ə k̚ ˨˩ ʔ
thuở	tʰ w əː ˧˨
thuỳ	tʰ w ɪ j ˦˩
thuỵ	tʰ w ɪ j ˨˩ ʔ
thuỷ	tʰ w ɪ j ˧˨
thà	tʰ aː ˦˩
thành	tʰ ɛ ɲ ˦˩
thác	tʰ aː k̚ ˦˧˥
thách	tʰ a t̚ ˦˧˥
thái	tʰ aː j ˨˩˦
tháng	tʰ aː ŋ ˦˧˥
thánh	tʰ ɛ ɲ ˦˧˥
tháo	tʰ aː w ˨˩˦
tháp	tʰ aː p̚ ˦˧˥
tháu	tʰ a w ˨˩˦
thâm	tʰ ə m ˧˧
thân	tʰ ə ŋ ˧˧
thâu	tʰ ə w ˧˧
thây	tʰ ə j ˧˧
thè	tʰ ɛ ˦˩
thèm	tʰ ɛ m ˦˩
thép	tʰ ɛ p̚ ˦˧˥
thêm	tʰ e m ˧˧
thêu	tʰ e w ˧˧
thêôđorô	tʰ e j ˧˧ ʔ o w ˧˧ ʔ ɗ ɔ ˧˧ ʐ o w ˧˧
thì	tʰ ɪ j ˦˩
thìa	tʰ i ə ˦˩
thìn	tʰ i n ˦˩
thí	tʰ ɪ j ˨˩˦
thích	tʰ ɨ t̚ ˦˧˥
thím	tʰ i m ˦˧˥
thính	tʰ ɨ n ˦˧˥
thò	tʰ ɔ ˦˩
thòng	tʰ a w ŋ͡m ˦˩
thóc	tʰ a w k͡p̚ ˦˧˥
thói	tʰ ɔ j ˨˩˦
thóp	tʰ ɔ p̚ ˦˧˥
thô	tʰ o w ˧˧
thôi	tʰ o j ˧˧
thôn	tʰ o ŋ ˧˧
thông	tʰ ə w ŋ͡m ˧˧
thù	tʰ ʊ w ˦˩
thùa	tʰ u ə ˦˩
thùng	tʰ ʊ w ŋ͡m ˦˩
thú	tʰ ʊ w ˨˩˦
thúc	tʰ ʊ w k͡p̚ ˦˧˥
thúi	tʰ u j ˨˩˦
thúng	tʰ ʊ w ŋ͡m ˦˧˥
thăm	tʰ a m ˧˧
thăn	tʰ a ŋ ˧˧
thăng	tʰ a ŋ ˧˧
thơ	tʰ əː ˧˧
thơm	tʰ əː m ˧˧
thư	tʰ ɨ ˧˧
thưa	tʰ ɨ ə ˧˧
thương	tʰ ɨ ə ŋ ˧˧
thước	tʰ ɨ ə k̚ ˦˧˥
thường	tʰ ɨ ə ŋ ˦˩
thưởng	tʰ ɨ ə ŋ ˧˨
thượng	tʰ ɨ ə ŋ ˨˩ ʔ
thạch	tʰ a t̚ ˨˩ ʔ
thạo	tʰ aː w ˨˩ ʔ
thả	tʰ aː ˧˨
thải	tʰ aː j ˧˨
thảm	tʰ aː m ˧˨
thảo	tʰ aː w ˧˨
thảy	tʰ a j ˧˨
thấm	tʰ ə m ˦˧˥
thấp	tʰ ə p̚ ˦˧˥
thất	tʰ ə k̚ ˦˧˥
thấu	tʰ ə w ˨˩˦
thấy	tʰ ə j ˨˩˦
thầm	tʰ ə m ˦˩
thần	tʰ ə ŋ ˦˩
thầu	tʰ ə w ˦˩
thầy	tʰ ə j ˦˩
thẩy	tʰ ə j ˧˨
thận	tʰ ə ŋ ˨˩ ʔ
thập	tʰ ə p̚ ˨˩ ʔ
thật	tʰ ə k̚ ˨˩ ʔ
thắm	tʰ a m ˦˧˥
thắng	tʰ a ŋ ˦˧˥
thắp	tʰ a p̚ ˦˧˥
thắt	tʰ a k̚ ˦˧˥
thằng	tʰ a ŋ ˦˩
thẳm	tʰ a m ˧˨
thẳng	tʰ a ŋ ˧˨
thẹn	tʰ ɛ ŋ ˨˩ ʔ
thẹo	tʰ ɛ w ˨˩ ʔ
thẻ	tʰ ɛ ˧˨
thế	tʰ e j ˨˩˦
thề	tʰ e j ˦˩
thềm	tʰ e m ˦˩
thể	tʰ e j ˧˨
thị	tʰ ɪ j ˨˩ ʔ
thịch	tʰ ɨ t̚ ˨˩ ʔ
thịnh	tʰ ɨ n ˨˩ ʔ
thịt	tʰ i t̚ ˨˩ ʔ
thọ	tʰ ɔ ˨˩ ʔ
thọc	tʰ a w k͡p̚ ˨˩ ʔ
thọt	tʰ ɔ k̚ ˨˩ ʔ
thỏ	tʰ ɔ ˧˨
thối	tʰ o j ˨˩˦
thốn	tʰ o ŋ ˦˧˥
thống	tʰ ə w ŋ͡m ˦˧˥
thốt	tʰ o k̚ ˦˧˥
thồn	tʰ o ŋ ˦˩
thổ	tʰ o w ˧˨
thổi	tʰ o j ˧˨
thớt	tʰ əː k̚ ˦˧˥
thờ	tʰ əː ˦˩
thời	tʰ əː j ˦˩
thở	tʰ əː ˧˨
thợ	tʰ əː ˨˩ ʔ
thụ	tʰ ʊ w ˨˩ ʔ
thục	tʰ ʊ w k͡p̚ ˨˩ ʔ
thụt	tʰ ʊ k̚ ˨˩ ʔ
thủ	tʰ ʊ w ˧˨
thủa	tʰ u ə ˧˨
thủm	tʰ u m ˧˨
thủng	tʰ ʊ w ŋ͡m ˧˨
thứ	tʰ ɨ ˨˩˦
thức	tʰ ɨ k̚ ˦˧˥
thừ	tʰ ɨ ˦˩
thừa	tʰ ɨ ə ˦˩
thừng	tʰ ɨ ŋ ˦˩
thử	tʰ ɨ ˧˨
thực	tʰ ɨ k̚ ˨˩ ʔ
ti	t ɪ j ˧˧
tia	t i ə ˧˧
tim	t i m ˧˧
tin	t i n ˧˧
tinh	t ɨ n ˧˧
titan	t ɪ j ˧˧ t aː n ˧˧
tiêm	t i ə m ˧˧
tiên	t i ə ŋ ˧˧
tiêu	t i w ˧˧
tiếc	t i ə k̚ ˦˧˥
tiến	t i ə ŋ ˦˧˥
tiếng	t i ə ŋ ˦˧˥
tiếp	t i ə p̚ ˦˧˥
tiết	t i ə k̚ ˦˧˥
tiền	t i ə ŋ ˦˩
tiều	t i w ˦˩
tiểu	t i w ˧˨
tiễn	t i ə ŋ ˧˨
tiệc	t i ə k̚ ˨˩ ʔ
tiệm	t i ə m ˨˩ ʔ
tiện	t i ə ŋ ˨˩ ʔ
tiệp	t i ə p̚ ˨˩ ʔ
to	t ɔ ˧˧
toa	t w aː ˧˧
toan	t w aː ŋ ˧˧
toang	t w aː ŋ ˧˧
toe	t w ɛ ˧˧
toi	t ɔ j ˧˧
tong	t a w ŋ͡m ˧˧
toà	t w aː ˦˩
toàn	t w aː ŋ ˦˩
toác	t w aː k̚ ˦˧˥
toán	t w aː ŋ ˦˧˥
toáng	t w aː ŋ ˦˧˥
toát	t w aː k̚ ˦˧˥
toé	t w ɛ ˨˩˦
toét	t w ɛ k̚ ˦˧˥
toả	t w aː ˧˨
tp	tʰ ɛ ɲ ˦˩ f o w ˨˩˦
tphcm	tʰ ɛ ɲ ˦˩ f o w ˨˩˦ h o w ˦˩ t͡ɕ ɪ j ˨˩˦ m ɨ n ˧˧
tra	ʈ aː ˧˧
trai	ʈ aː j ˧˧
trang	ʈ aː ŋ ˧˧
tranh	ʈ ɛ ɲ ˧˧
trao	ʈ aː w ˧˧
trau	ʈ a w ˧˧
tre	ʈ ɛ ˧˧
treo	ʈ ɛ w ˧˧
trinh	ʈ ɨ n ˧˧
triết	ʈ i ə k̚ ˦˧˥
triền	ʈ i ə ŋ ˦˩
triều	ʈ i w ˦˩
triện	ʈ i ə ŋ ˨˩ ʔ
triệt	ʈ i ə k̚ ˨˩ ʔ
triệu	ʈ i w ˨˩ ʔ
tro	ʈ ɔ ˧˧
trong	ʈ a w ŋ͡m ˧˧
tru	ʈ ʊ w ˧˧
trung	ʈ ʊ w ŋ͡m ˧˧
truy	ʈ w ɪ j ˧˧
truyền	ʈ w i ə ŋ ˦˩
truyện	ʈ w i ə ŋ ˨˩ ʔ
truông	ʈ u ə ŋ ˧˧
truất	ʈ w ə k̚ ˦˧˥
truồng	ʈ u ə ŋ ˦˩
trà	ʈ aː ˦˩
tràm	ʈ aː m ˦˩
tràn	ʈ aː ŋ ˦˩
tràng	ʈ aː ŋ ˦˩
trào	ʈ aː w ˦˩
trách	ʈ a t̚ ˦˧˥
trái	ʈ aː j ˨˩˦
trám	ʈ aː m ˦˧˥
trán	ʈ aː ŋ ˦˧˥
tráng	ʈ aː ŋ ˦˧˥
tránh	ʈ ɛ ɲ ˦˧˥
tráo	ʈ aː w ˨˩˦
tráp	ʈ aː p̚ ˦˧˥
trát	ʈ aː k̚ ˦˧˥
trâm	ʈ ə m ˧˧
trân	ʈ ə ŋ ˧˧
trâu	ʈ ə w ˧˧
trã	ʈ aː ˧˨
trèo	ʈ ɛ w ˦˩
trét	ʈ ɛ t̚ ˦˧˥
trên	ʈ e n ˧˧
trêu	ʈ e w ˧˧
trình	ʈ ɨ n ˦˩
trí	ʈ ɪ j ˨˩˦
trích	ʈ ɨ t̚ ˦˧˥
trò	ʈ ɔ ˦˩
tròn	ʈ ɔ ŋ ˦˩
tròng	ʈ a w ŋ͡m ˦˩
tróc	ʈ a w k͡p̚ ˦˧˥
trói	ʈ ɔ j ˨˩˦
trót	ʈ ɔ k̚ ˦˧˥
trôi	ʈ o j ˧˧
trông	ʈ ə w ŋ͡m ˧˧
trù	ʈ ʊ w ˦˩
trùm	ʈ u m ˦˩
trùn	ʈ u n ˦˩
trùng	ʈ ʊ w ŋ͡m ˦˩
trú	ʈ ʊ w ˨˩˦
trúc	ʈ ʊ w k͡p̚ ˦˧˥
trúng	ʈ ʊ w ŋ͡m ˦˧˥
trút	ʈ ʊ k̚ ˦˧˥
trăm	ʈ a m ˧˧
trăn	ʈ a ŋ ˧˧
trăng	ʈ a ŋ ˧˧
trĩ	ʈ ɪ j ˧˨
trĩu	ʈ i w ˧˨
trũng	ʈ ʊ w ŋ͡m ˧˨
trơ	ʈ əː ˧˧
trơn	ʈ əː ŋ ˧˧
trưa	ʈ ɨ ə ˧˧
trưng	ʈ ɨ ŋ ˧˧
trương	ʈ ɨ ə ŋ ˧˧
trước	ʈ ɨ ə k̚ ˦˧˥
trườn	ʈ ɨ ə ŋ ˦˩
trường	ʈ ɨ ə ŋ ˦˩
trưởng	ʈ ɨ ə ŋ ˧˨
trượng	ʈ ɨ ə ŋ ˨˩ ʔ
trượt	ʈ ɨ ə k̚ ˨˩ ʔ
trạc	ʈ aː k̚ ˨˩ ʔ
trại	ʈ aː j ˨˩ ʔ
trạm	ʈ aː m ˨˩ ʔ
trạng	ʈ aː ŋ ˨˩ ʔ
trả	ʈ aː ˧˨
trải	ʈ aː j ˧˨
trảm	ʈ aː m ˧˨
trảng	ʈ aː ŋ ˧˨
trấn	ʈ ə ŋ ˦˧˥
trấu	ʈ ə w ˨˩˦
trầm	ʈ ə m ˦˩
trần	ʈ ə ŋ ˦˩
trầu	ʈ ə w ˦˩
trầy	ʈ ə j ˦˩
trẩu	ʈ ə w ˧˨
trẫm	ʈ ə m ˧˨
trận	ʈ ə ŋ ˨˩ ʔ
trật	ʈ ə k̚ ˨˩ ʔ
trắc	ʈ a k̚ ˦˧˥
trắm	ʈ a m ˦˧˥
trắng	ʈ a ŋ ˦˧˥
trặc	ʈ a k̚ ˨˩ ʔ
trẹo	ʈ ɛ w ˨˩ ʔ
trẻ	ʈ ɛ ˧˨
trề	ʈ e j ˦˩
trển	ʈ e n ˧˨
trễ	ʈ e j ˧˨
trệt	ʈ e t̚ ˨˩ ʔ
trị	ʈ ɪ j ˨˩ ʔ
trịnh	ʈ ɨ n ˨˩ ʔ
trọ	ʈ ɔ ˨˩ ʔ
trọc	ʈ a w k͡p̚ ˨˩ ʔ
trọi	ʈ ɔ j ˨˩ ʔ
trọn	ʈ ɔ ŋ ˨˩ ʔ
trọng	ʈ a w ŋ͡m ˨˩ ʔ
trỏ	ʈ ɔ ˧˨
trỏng	ʈ a w ŋ͡m ˧˨
trốc	ʈ ə w k͡p̚ ˦˧˥
trốn	ʈ o ŋ ˦˧˥
trống	ʈ ə w ŋ͡m ˦˧˥
trồi	ʈ o j ˦˩
trồng	ʈ ə w ŋ͡m ˦˩
trổ	ʈ o w ˧˨
trội	ʈ o j ˨˩ ʔ
trộm	ʈ o m ˨˩ ʔ
trộn	ʈ o ŋ ˨˩ ʔ
trớn	ʈ əː ŋ ˦˧˥
trời	ʈ əː j ˦˩
trở	ʈ əː ˧˨
trợn	ʈ əː ŋ ˨˩ ʔ
trụ	ʈ ʊ w ˨˩ ʔ
trục	ʈ ʊ w k͡p̚ ˨˩ ʔ
trụi	ʈ u j ˨˩ ʔ
trụng	ʈ ʊ w ŋ͡m ˨˩ ʔ
trủ	ʈ ʊ w ˧˨
trứng	ʈ ɨ ŋ ˦˧˥
trừ	ʈ ɨ ˦˩
trữ	ʈ ɨ ˧˨
trực	ʈ ɨ k̚ ˨˩ ʔ
ttx	tʰ ə w ŋ͡m ˧˧ t ə ŋ ˦˧˥ s aː ˧˨
tu	t ʊ w ˧˧
tua	t u ə ˧˧
tui	t u j ˧˧
tuli	t ʊ w ˧˧ l ɪ j ˧˧
tum	t u m ˧˧
tung	t ʊ w ŋ͡m ˧˧
tuy	t w ɪ j ˧˧
tuyến	t w i ə ŋ ˦˧˥
tuyết	t w i ə k̚ ˦˧˥
tuyển	t w i ə ŋ ˧˨
tuyệt	t w i ə k̚ ˨˩ ʔ
tuân	t w ə ŋ ˧˧
tuôn	t u ə ŋ ˧˧
tuýp	t w i p̚ ˦˧˥
tuấn	t w ə ŋ ˦˧˥
tuất	t w ə k̚ ˦˧˥
tuần	t w ə ŋ ˦˩
tuế	t w e j ˨˩˦
tuốt	t u ə k̚ ˦˧˥
tuồng	t u ə ŋ ˦˩
tuổi	t u j ˧˨
tuột	t u ə k̚ ˨˩ ʔ
tuỳ	t w ɪ j ˦˩
tuỵ	t w ɪ j ˨˩ ʔ
tuỷ	t w ɪ j ˧˨
tv	t ɪ j ˧˧ v ɪ j ˧˧
tà	t aː ˦˩
tài	t aː j ˦˩
tàn	t aː ŋ ˦˩
tàng	t aː ŋ ˦˩
tàu	t a w ˦˩
tày	t a j ˦˩
tá	t aː ˨˩˦
tách	t a t̚ ˦˧˥
tái	t aː j ˨˩˦
tám	t aː m ˦˧˥
tán	t aː ŋ ˦˧˥
táng	t aː ŋ ˦˧˥
tánh	t ɛ ɲ ˦˧˥
táo	t aː w ˨˩˦
táp	t aː p̚ ˦˧˥
tát	t aː k̚ ˦˧˥
tâm	t ə m ˧˧
tân	t ə ŋ ˧˧
tâng	t ə ŋ ˧˧
tâu	t ə w ˧˧
tây	t ə j ˧˧
tã	t aː ˧˨
tãi	t aː j ˧˨
tè	t ɛ ˦˩
té	t ɛ ˨˩˦
tém	t ɛ m ˦˧˥
tép	t ɛ p̚ ˦˧˥
tét	t ɛ t̚ ˦˧˥
tê	t e j ˧˧
têhêrăng	t e j ˧˧ h e j ˧˧ ɹ a ŋ ˧˧
têm	t e m ˧˧
tên	t e n ˧˧
tênh	t e n ˧˧
têooc	t e j ˧˧ ʔ ɔ k̚ ˧˧
têrêsa	t e j ˧˧ ʐ e j ˧˧ s aː ˧˧
tìm	t i m ˦˩
tình	t ɨ n ˦˩
tí	t ɪ j ˨˩˦
tía	t i ə ˨˩˦
tích	t ɨ t̚ ˦˧˥
tím	t i m ˦˧˥
tính	t ɨ n ˦˧˥
típ	t i p̚ ˦˧˥
tít	t i t̚ ˦˧˥
tóc	t a w k͡p̚ ˦˧˥
tóm	t ɔ m ˦˧˥
tót	t ɔ k̚ ˦˧˥
tô	t o w ˧˧
tôi	t o j ˧˧
tôm	t o m ˧˧
tôma	t o w ˧˧ m aː ˧˧
tôn	t o ŋ ˧˧
tông	t ə w ŋ͡m ˧˧
tõm	t ɔ m ˧˨
tù	t ʊ w ˦˩
tùng	t ʊ w ŋ͡m ˦˩
tú	t ʊ w ˨˩˦
túa	t u ə ˨˩˦
túi	t u j ˨˩˦
túm	t u m ˦˧˥
tút	t ʊ k̚ ˦˧˥
tăm	t a m ˧˧
tăng	t a ŋ ˧˧
tơ	t əː ˧˧
tơi	t əː j ˧˧
tư	t ɨ ˧˧
tưng	t ɨ ŋ ˧˧
tươi	t ɨ j ˧˧
tươm	t ɨ ə m ˧˧
tương	t ɨ ə ŋ ˧˧
tước	t ɨ ə k̚ ˦˧˥
tưới	t ɨ j ˨˩˦
tướng	t ɨ ə ŋ ˦˧˥
tường	t ɨ ə ŋ ˦˩
tườu	t ɨ ə w ˦˩
tưởng	t ɨ ə ŋ ˧˨
tượng	t ɨ ə ŋ ˨˩ ʔ
tạ	t aː ˨˩ ʔ
tạc	t aː k̚ ˨˩ ʔ
tại	t aː j ˨˩ ʔ
tạm	t aː m ˨˩ ʔ
tạng	t aː ŋ ˨˩ ʔ
tạnh	t ɛ ɲ ˨˩ ʔ
tạo	t aː w ˨˩ ʔ
tạt	t aː k̚ ˨˩ ʔ
tả	t aː ˧˨
tải	t aː j ˧˨
tản	t aː ŋ ˧˨
tảng	t aː ŋ ˧˨
tảo	t aː w ˧˨
tấc	t ə k̚ ˦˧˥
tấm	t ə m ˦˧˥
tấn	t ə ŋ ˦˧˥
tất	t ə k̚ ˦˧˥
tấu	t ə w ˨˩˦
tầm	t ə m ˦˩
tầng	t ə ŋ ˦˩
tẩm	t ə m ˧˨
tẩn	t ə ŋ ˧˨
tẩu	t ə w ˧˨
tẩy	t ə j ˧˨
tận	t ə ŋ ˨˩ ʔ
tập	t ə p̚ ˨˩ ʔ
tật	t ə k̚ ˨˩ ʔ
tậu	t ə w ˨˩ ʔ
tắc	t a k̚ ˦˧˥
tắm	t a m ˦˧˥
tắp	t a p̚ ˦˧˥
tắt	t a k̚ ˦˧˥
tằm	t a m ˦˩
tặc	t a k̚ ˨˩ ʔ
tặng	t a ŋ ˨˩ ʔ
tẹo	t ɛ w ˨˩ ʔ
tẹt	t ɛ t̚ ˨˩ ʔ
tẻ	t ɛ ˧˨
tế	t e j ˨˩˦
tếch	t e t̚ ˦˧˥
tết	t e t̚ ˦˧˥
tệ	t e j ˨˩ ʔ
tệp	t e p̚ ˨˩ ʔ
tỉ	t ɪ j ˧˨
tỉa	t i ə ˧˨
tỉnh	t ɨ n ˧˨
tị	t ɪ j ˨˩ ʔ
tịch	t ɨ t̚ ˨˩ ʔ
tịt	t i t̚ ˨˩ ʔ
tọp	t ɔ p̚ ˨˩ ʔ
tỏ	t ɔ ˧˨
tỏi	t ɔ j ˧˨
tỏm	t ɔ m ˧˨
tố	t o w ˨˩˦
tốc	t ə w k͡p̚ ˦˧˥
tối	t o j ˨˩˦
tốn	t o ŋ ˦˧˥
tống	t ə w ŋ͡m ˦˧˥
tốp	t o p̚ ˦˧˥
tốt	t o k̚ ˦˧˥
tồi	t o j ˦˩
tồn	t o ŋ ˦˩
tổ	t o w ˧˨
tổng	t ə w ŋ͡m ˧˨
tộ	t o w ˨˩ ʔ
tộc	t ə w k͡p̚ ˨˩ ʔ
tội	t o j ˨˩ ʔ
tột	t o k̚ ˨˩ ʔ
tớ	t əː ˨˩˦
tới	t əː j ˨˩˦
tờ	t əː ˦˩
tởm	t əː m ˧˨
tởn	t əː ŋ ˧˨
tợ	t əː ˨˩ ʔ
tợn	t əː ŋ ˨˩ ʔ
tợp	t əː p̚ ˨˩ ʔ
tục	t ʊ w k͡p̚ ˨˩ ʔ
tụi	t u j ˨˩ ʔ
tụm	t u m ˨˩ ʔ
tụng	t ʊ w ŋ͡m ˨˩ ʔ
tụt	t ʊ k̚ ˨˩ ʔ
tủ	t ʊ w ˧˨
tủi	t u j ˧˨
tức	t ɨ k̚ ˦˧˥
từ	t ɨ ˦˩
từng	t ɨ ŋ ˦˩
tử	t ɨ ˧˨
tửu	t ɨ w ˧˨
tự	t ɨ ˨˩ ʔ
tựa	t ɨ ə ˨˩ ʔ
u	ʔ ʊ w ˧˧
ung	ʔ ʊ w ŋ͡m ˧˧
urani	ʔ ʊ w ˧˧ ɹ aː ˧˧ n ɪ j ˧˧
urbanô	ʔ w əː ˧˧ ʔ ɓ aː ŋ ˧˧ n o w ˧˧
uyên	ʔ w i ə ŋ ˧˧
uên	ʔ w e n ˧˧
uôn	ʔ u ə ŋ ˧˧
uý	ʔ w ɪ j ˨˩˦
uất	ʔ w ə k̚ ˦˧˥
uốn	ʔ u ə ŋ ˦˧˥
uống	ʔ u ə ŋ ˦˧˥
uổng	ʔ u ə ŋ ˧˨
v	v e j ˧˧
va	v aː ˧˧
vai	v aː j ˧˧
valentinô	v aː ˧˧ l ɛ ŋ ˧˧ t i n ˧˧ n o w ˧˧
van	v aː ŋ ˧˧
vanađi	v aː ˧˧ n aː ˧˧ ʔ ɗ ɪ j ˧˧
vang	v aː ŋ ˧˧
vay	v a j ˧˧
ve	v ɛ ˧˧
vectơ	v ɛ k̚ ˦˧˥ t əː ˧˧
ven	v ɛ ŋ ˧˧
vi	v ɪ j ˧˧
victor	v ɨ t̚ ˦˧˥ t ɔ ˧˧
vinh	v ɨ n ˧˧
viêm	v i ə m ˧˧
viên	v i ə ŋ ˧˧
viếng	v i ə ŋ ˦˧˥
viết	v i ə k̚ ˦˧˥
viền	v i ə ŋ ˦˩
việc	v i ə k̚ ˨˩ ʔ
viện	v i ə ŋ ˨˩ ʔ
việt	v i ə k̚ ˨˩ ʔ
vo	v ɔ ˧˧
voa	v w aː ˧˧
voan	v w aː ŋ ˧˧
voi	v ɔ j ˧˧
vonfam	v o ŋ ˧˧ f aː m ˧˧
voọc	v ɔ k̚ ˨˩ ʔ
vu	v ʊ w ˧˧
vua	v u ə ˧˧
vui	v u j ˧˧
vun	v u n ˧˧
vung	v ʊ w ŋ͡m ˧˧
vuông	v u ə ŋ ˧˧
vuốt	v u ə k̚ ˦˧˥
vuột	v u ə k̚ ˨˩ ʔ
vy	v ɪ j ˧˧
và	v aː ˦˩
vài	v aː j ˦˩
vàng	v aː ŋ ˦˩
vành	v ɛ ɲ ˦˩
vào	v aː w ˦˩
vá	v aː ˨˩˦
vác	v aː k̚ ˦˧˥
vách	v a t̚ ˦˧˥
vái	v aː j ˨˩˦
ván	v aː ŋ ˦˧˥
váng	v aː ŋ ˦˧˥
váy	v a j ˨˩˦
vân	v ə ŋ ˧˧
vâng	v ə ŋ ˧˧
vây	v ə j ˧˧
vã	v aː ˧˨
vãi	v aː j ˧˨
vè	v ɛ ˦˩
vé	v ɛ ˨˩˦
vén	v ɛ ŋ ˦˧˥
véo	v ɛ w ˨˩˦
vét	v ɛ t̚ ˦˧˥
vê	v e j ˧˧
vênh	v e n ˧˧
vì	v ɪ j ˦˩
ví	v ɪ j ˨˩˦
vía	v i ə ˨˩˦
vích	v ɨ t̚ ˦˧˥
vít	v i t̚ ˦˧˥
víu	v i w ˨˩˦
vò	v ɔ ˦˩
vòi	v ɔ j ˦˩
vòm	v ɔ m ˦˩
vòng	v a w ŋ͡m ˦˩
vó	v ɔ ˨˩˦
vóc	v a w k͡p̚ ˦˧˥
vón	v ɔ ŋ ˦˧˥
vót	v ɔ k̚ ˦˧˥
vô	v o w ˧˧
vôi	v o j ˧˧
vôn	v o ŋ ˧˧
võ	v ɔ ˧˨
võng	v a w ŋ͡m ˧˨
vù	v ʊ w ˦˩
vùi	v u j ˦˩
vùng	v ʊ w ŋ͡m ˦˩
vú	v ʊ w ˨˩˦
vút	v ʊ k̚ ˦˧˥
văn	v a ŋ ˧˧
văng	v a ŋ ˧˧
vĩ	v ɪ j ˧˨
vũ	v ʊ w ˧˨
vũng	v ʊ w ŋ͡m ˧˨
vơi	v əː j ˧˧
vưu	v ɨ w ˧˧
vươn	v ɨ ə ŋ ˧˧
vương	v ɨ ə ŋ ˧˧
vướng	v ɨ ə ŋ ˦˧˥
vườn	v ɨ ə ŋ ˦˩
vượn	v ɨ ə ŋ ˨˩ ʔ
vượng	v ɨ ə ŋ ˨˩ ʔ
vượt	v ɨ ə k̚ ˨˩ ʔ
vạ	v aː ˨˩ ʔ
vạc	v aː k̚ ˨˩ ʔ
vạch	v a t̚ ˨˩ ʔ
vạn	v aː ŋ ˨˩ ʔ
vạt	v aː k̚ ˨˩ ʔ
vả	v aː ˧˨
vải	v aː j ˧˨
vảy	v a j ˧˨
vấn	v ə ŋ ˦˧˥
vấp	v ə p̚ ˦˧˥
vất	v ə k̚ ˦˧˥
vấy	v ə j ˨˩˦
vần	v ə ŋ ˦˩
vầng	v ə ŋ ˦˩
vầy	v ə j ˦˩
vẫn	v ə ŋ ˧˨
vẫy	v ə j ˧˨
vận	v ə ŋ ˨˩ ʔ
vật	v ə k̚ ˨˩ ʔ
vậy	v ə j ˨˩ ʔ
vắng	v a ŋ ˦˧˥
vắt	v a k̚ ˦˧˥
vằn	v a ŋ ˦˩
vặc	v a k̚ ˨˩ ʔ
vặn	v a ŋ ˨˩ ʔ
vặt	v a k̚ ˨˩ ʔ
vẹm	v ɛ m ˨˩ ʔ
vẹn	v ɛ ŋ ˨˩ ʔ
vẹo	v ɛ w ˨˩ ʔ
vẹt	v ɛ t̚ ˨˩ ʔ
vẻ	v ɛ ˧˨
vẽ	v ɛ ˧˨
vế	v e j ˨˩˦
vết	v e t̚ ˦˧˥
vếu	v e w ˨˩˦
về	v e j ˦˩
vểnh	v e n ˧˨
vệ	v e j ˨˩ ʔ
vện	v e n ˨˩ ʔ
vệt	v e t̚ ˨˩ ʔ
vỉ	v ɪ j ˧˨
vỉa	v i ə ˧˨
vị	v ɪ j ˨˩ ʔ
vịn	v i n ˨˩ ʔ
vịnh	v ɨ n ˨˩ ʔ
vịt	v i t̚ ˨˩ ʔ
vọc	v a w k͡p̚ ˨˩ ʔ
vọng	v a w ŋ͡m ˨˩ ʔ
vọt	v ɔ k̚ ˨˩ ʔ
vỏ	v ɔ ˧˨
vốc	v ə w k͡p̚ ˦˧˥
vốn	v o ŋ ˦˧˥
vồ	v o w ˦˩
vồng	v ə w ŋ͡m ˦˩
vỗ	v o w ˧˨
vội	v o j ˨˩ ʔ
vớ	v əː ˨˩˦
với	v əː j ˨˩˦
vớt	v əː k̚ ˦˧˥
vờ	v əː ˦˩
vời	v əː j ˦˩
vờn	v əː ŋ ˦˩
vở	v əː ˧˨
vỡ	v əː ˧˨
vợ	v əː ˨˩ ʔ
vợt	v əː k̚ ˨˩ ʔ
vụ	v ʊ w ˨˩ ʔ
vụn	v u n ˨˩ ʔ
vụng	v ʊ w ŋ͡m ˨˩ ʔ
vụt	v ʊ k̚ ˨˩ ʔ
vứt	v ɨ k̚ ˦˧˥
vừa	v ɨ ə ˦˩
vừng	v ɨ ŋ ˦˩
vữa	v ɨ ə ˧˨
vững	v ɨ ŋ ˧˨
vựa	v ɨ ə ˨˩ ʔ
vực	v ɨ k̚ ˨˩ ʔ
x	ʔ i t̚ ˦˧˥ ʂ ɪ j ˦˩
xa	s aː ˧˧
xanh	s ɛ ɲ ˧˧
xaviê	s aː ˧˧ v ɪ j ˧˧ ʔ e j ˧˧
xay	s a j ˧˧
xe	s ɛ ˧˧
xem	s ɛ m ˧˧
xen	s ɛ ŋ ˧˧
xenon	s e j ˧˧ n ə w ŋ͡m ˧˧
xeri	s ɛ ˧˧ ɹ ɪ j ˧˧
xesi	s e j ˧˧ s ɪ j ˧˧
xin	s i n ˧˧
xinh	s ɨ n ˧˧
xiêm	s i ə m ˧˧
xiên	s i ə ŋ ˧˧
xiêu	s i w ˧˧
xiếc	s i ə k̚ ˦˧˥
xiềng	s i ə ŋ ˦˩
xoa	s w aː ˧˧
xoang	s w aː ŋ ˧˧
xoay	s w a j ˧˧
xoe	s w ɛ ˧˧
xoi	s ɔ j ˧˧
xong	s a w ŋ͡m ˧˧
xoong	s ɔ ŋ͡m ˧˧
xoài	s w aː j ˦˩
xoàn	s w aː ŋ ˦˩
xoá	s w aː ˨˩˦
xoáy	s w a j ˨˩˦
xoã	s w aː ˧˨
xoè	s w ɛ ˦˩
xoăn	s w a ŋ ˧˧
xoạc	s w aː k̚ ˨˩ ʔ
xoắn	s w a ŋ ˦˧˥
xtiêng	s t i ə ŋ ˧˧
xu	s ʊ w ˧˧
xua	s u ə ˧˧
xui	s u j ˧˧
xung	s ʊ w ŋ͡m ˧˧
xuyên	s w i ə ŋ ˧˧
xuyến	s w i ə ŋ ˦˧˥
xuân	s w ə ŋ ˧˧
xuôi	s u j ˧˧
xuýt	s w ɨ t̚ ˦˧˥
xuất	s w ə k̚ ˦˧˥
xuống	s u ə ŋ ˦˧˥
xuồng	s u ə ŋ ˦˩
xà	s aː ˦˩
xài	s aː j ˦˩
xàm	s aː m ˦˩
xào	s aː w ˦˩
xá	s aː ˨˩˦
xác	s aː k̚ ˦˧˥
xách	s a t̚ ˦˧˥
xái	s aː j ˨˩˦
xám	s aː m ˦˧˥
xáo	s aː w ˨˩˦
xát	s aː k̚ ˦˧˥
xáy	s a j ˨˩˦
xâu	s ə w ˧˧
xây	s ə j ˧˧
xã	s aː ˧˨
xèng	s ɛ ŋ ˦˩
xèo	s ɛ w ˦˩
xé	s ɛ ˨˩˦
xém	s ɛ m ˦˧˥
xén	s ɛ ŋ ˦˧˥
xéo	s ɛ w ˨˩˦
xét	s ɛ t̚ ˦˧˥
xê	s e j ˧˧
xì	s ɪ j ˦˩
xí	s ɪ j ˨˩˦
xía	s i ə ˨˩˦
xích	s ɨ t̚ ˦˧˥
xíu	s i w ˨˩˦
xó	s ɔ ˨˩˦
xóc	s a w k͡p̚ ˦˧˥
xói	s ɔ j ˨˩˦
xóm	s ɔ m ˦˧˥
xót	s ɔ k̚ ˦˧˥
xô	s o w ˧˧
xôi	s o j ˧˧
xông	s ə w ŋ͡m ˧˧
xù	s ʊ w ˦˩
xúc	s ʊ w k͡p̚ ˦˧˥
xúi	s u j ˨˩˦
xúm	s u m ˦˧˥
xúp	s u p̚ ˦˧˥
xút	s ʊ k̚ ˦˧˥
xăm	s a m ˧˧
xăng	s a ŋ ˧˧
xơ	s əː ˧˧
xơi	s əː j ˧˧
xưa	s ɨ ə ˧˧
xưng	s ɨ ŋ ˧˧
xương	s ɨ ə ŋ ˧˧
xước	s ɨ ə k̚ ˦˧˥
xướng	s ɨ ə ŋ ˦˧˥
xưởng	s ɨ ə ŋ ˧˨
xạo	s aː w ˨˩ ʔ
xả	s aː ˧˨
xảo	s aː w ˧˨
xảy	s a j ˧˨
xấp	s ə p̚ ˦˧˥
xấu	s ə w ˨˩˦
xắn	s a ŋ ˦˧˥
xắt	s a k̚ ˦˧˥
xẹp	s ɛ p̚ ˨˩ ʔ
xẻ	s ɛ ˧˨
xẻng	s ɛ ŋ ˧˨
xế	s e j ˨˩˦
xếch	s e t̚ ˦˧˥
xếp	s e p̚ ˦˧˥
xệ	s e j ˨˩ ʔ
xỉa	s i ə ˧˨
xỉn	s i n ˧˨
xỉu	s i w ˧˨
xị	s ɪ j ˨˩ ʔ
xịn	s i n ˨˩ ʔ
xịt	s i t̚ ˨˩ ʔ
xỏ	s ɔ ˧˨
xốc	s ə w k͡p̚ ˦˧˥
xối	s o j ˨˩˦
xốp	s o p̚ ˦˧˥
xốt	s o k̚ ˦˧˥
xới	s əː j ˨˩˦
xứ	s ɨ ˨˩˦
xức	s ɨ k̚ ˦˧˥
xử	s ɨ ˧˨
xực	s ɨ k̚ ˨˩ ʔ
y	ʔ ɪ j ˧˧
y	ʔ ɪ j ˧˧ j aː j ˦˩
ytecbi	ʔ ɪ j ˧˧ t ɛ k̚ ˦˧˥ ʔ ɓ ɪ j ˧˧
ytri	ʔ ɪ j ˧˧ ʈ ɪ j ˧˧
yên	ʔ i ə ŋ ˧˧
yêu	ʔ i w ˧˧
yếm	ʔ i ə m ˦˧˥
yến	ʔ i ə ŋ ˦˧˥
yếu	ʔ i w ˨˩˦
yểm	ʔ i ə m ˧˨
yểu	ʔ i w ˧˨
ziriconi	z ɪ j ˧˧ ɹ ɪ j ˧˧ k ɔ ˧˧ n ɪ j ˧˧
à	ʔ aː ˦˩
ào	ʔ aː w ˦˩
á	ʔ aː ˨˩˦
ác	ʔ aː k̚ ˦˧˥
ách	ʔ a t̚ ˦˧˥
ái	ʔ aː j ˨˩˦
ám	ʔ aː m ˦˧˥
án	ʔ aː ŋ ˦˧˥
áng	ʔ aː ŋ ˦˧˥
ánh	ʔ ɛ ɲ ˦˧˥
áo	ʔ aː w ˨˩˦
áp	ʔ aː p̚ ˦˧˥
át	ʔ aː k̚ ˦˧˥
â	ʔ əː ˨˩˦
âm	ʔ ə m ˧˧
ân	ʔ ə ŋ ˧˧
âu	ʔ ə w ˧˧
éc	ʔ ɛ k̚ ˦˧˥
ém	ʔ ɛ m ˦˧˥
én	ʔ ɛ ŋ ˦˧˥
éo	ʔ ɛ w ˨˩˦
ép	ʔ ɛ p̚ ˦˧˥
ét	ʔ ɛ t̚ ˦˧˥
ê	ʔ e j ˧˧
êkip	ʔ e j ˧˧ k i p̚ ˦˧˥
êm	ʔ e m ˧˧
êtanol	ʔ e j ˧˧ t aː ˧˧ n ɔ ŋ ˧˧
êugêniô	ʔ e w ˧˧ ɣ e n ˧˧ n ɪ j ˧˧ ʔ o w ˧˧
ì	ʔ ɪ j ˦˩
ích	ʔ ɨ t̚ ˦˧˥
ít	ʔ i t̚ ˦˧˥
ítcariốt	ʔ i t̚ ˦˧˥ k aː ˧˧ ɹ ɪ j ˧˧ ʔ o k̚ ˦˧˥
ó	ʔ ɔ ˨˩˦
óc	ʔ a w k͡p̚ ˦˧˥
ói	ʔ ɔ j ˨˩˦
óng	ʔ a w ŋ͡m ˦˧˥
ót	ʔ ɔ k̚ ˦˧˥
ô	ʔ o w ˧˧
ôbace	ʔ ə w ŋ͡m ˧˧ ʔ ɓ aː ˦˩ ʔ ɛ ɲ ˧˧ t͡ɕ ɪ j ˨˩ ʔ ʔ ɛ m ˧˧
ôi	ʔ o j ˧˧
ôm	ʔ o m ˧˧
ôn	ʔ o ŋ ˧˧
ông	ʔ ə w ŋ͡m ˧˧
ôzôn	ʔ o w ˧˧ z o n ˧˧
ù	ʔ ʊ w ˦˩
ùn	ʔ u n ˦˩
ú	ʔ ʊ w ˨˩˦
úa	ʔ u ə ˨˩˦
úc	ʔ ʊ w k͡p̚ ˦˧˥
úi	ʔ u j ˨˩˦
úng	ʔ ʊ w ŋ͡m ˦˧˥
úp	ʔ u p̚ ˦˧˥
út	ʔ ʊ k̚ ˦˧˥
ý	ʔ ɪ j ˨˩˦
ă	ʔ aː ˨˩˦
ăn	ʔ a ŋ ˧˧
đ	ʔ ɗ e j ˧˧
đa	ʔ ɗ aː ˧˧
đai	ʔ ɗ aː j ˧˧
đam	ʔ ɗ aː m ˧˧
đaminh	ʔ ɗ aː ˧˧ m ɨ n ˧˧
đan	ʔ ɗ aː ŋ ˧˧
đang	ʔ ɗ aː ŋ ˧˧
đanh	ʔ ɗ ɛ ɲ ˧˧
đao	ʔ ɗ aː w ˧˧
đau	ʔ ɗ a w ˧˧
đay	ʔ ɗ a j ˧˧
đcg	ʔ ɗ ɨ k̚ ˦˧˥ t͡ɕ u ə ˨˩˦ j e j ˧˧ ʂ ʊ w ˧˧
đe	ʔ ɗ ɛ ˧˧
đem	ʔ ɗ ɛ m ˧˧
đen	ʔ ɗ ɛ ŋ ˧˧
đeo	ʔ ɗ ɛ w ˧˧
đhy	ʔ ɗ ɨ k̚ ˦˧˥ h ə w ŋ͡m ˦˩ ʔ ɪ j ˧˧
đi	ʔ ɗ ɪ j ˧˧
đinh	ʔ ɗ ɨ n ˧˧
điprozi	ʔ ɗ i p̚ ˧˧ ɹ ɔ ˧˧ z ɪ j ˧˧
điên	ʔ ɗ i ə ŋ ˧˧
điêu	ʔ ɗ i w ˧˧
điônisiô	ʔ ɗ ɪ j ˧˧ ʔ o ŋ ˧˧ n ɪ j ˧˧ s ɪ j ˧˧ ʔ o w ˧˧
điếc	ʔ ɗ i ə k̚ ˦˧˥
điếm	ʔ ɗ i ə m ˦˧˥
điếu	ʔ ɗ i w ˨˩˦
điền	ʔ ɗ i ə ŋ ˦˩
điều	ʔ ɗ i w ˦˩
điểm	ʔ ɗ i ə m ˧˨
điển	ʔ ɗ i ə ŋ ˧˨
điện	ʔ ɗ i ə ŋ ˨˩ ʔ
điệp	ʔ ɗ i ə p̚ ˨˩ ʔ
điệu	ʔ ɗ i w ˨˩ ʔ
đm	ʔ ɗ əː ˦˩ m əː ˦˩
đo	ʔ ɗ ɔ ˧˧
đoan	ʔ ɗ w aː ŋ ˧˧
đong	ʔ ɗ a w ŋ͡m ˧˧
đoàn	ʔ ɗ w aː ŋ ˦˩
đoá	ʔ ɗ w aː ˨˩˦
đoán	ʔ ɗ w aː ŋ ˦˧˥
đoạn	ʔ ɗ w aː ŋ ˨˩ ʔ
đoạt	ʔ ɗ w aː k̚ ˨˩ ʔ
đoản	ʔ ɗ w aː ŋ ˧˨
đtdđ	ʔ ɗ i ə ŋ ˨˩ ʔ tʰ w aː j ˨˩ ʔ j ɪ j ˧˧ ʔ ɗ ə w ŋ͡m ˨˩ ʔ
đu	ʔ ɗ ʊ w ˧˧
đua	ʔ ɗ u ə ˧˧
đui	ʔ ɗ u j ˧˧
đun	ʔ ɗ u n ˧˧
đupni	ʔ ɗ u p̚ ˦˧˥ n ɪ j ˧˧
đuôi	ʔ ɗ u j ˧˧
đuông	ʔ ɗ u ə ŋ ˧˧
đuốc	ʔ ɗ u ə k̚ ˦˧˥
đuối	ʔ ɗ u j ˨˩˦
đuổi	ʔ ɗ u j ˧˨
đà	ʔ ɗ aː ˦˩
đài	ʔ ɗ aː j ˦˩
đàm	ʔ ɗ aː m ˦˩
đàn	ʔ ɗ aː ŋ ˦˩
đàng	ʔ ɗ aː ŋ ˦˩
đành	ʔ ɗ ɛ ɲ ˦˩
đào	ʔ ɗ aː w ˦˩
đày	ʔ ɗ a j ˦˩
đá	ʔ ɗ aː ˨˩˦
đái	ʔ ɗ aː j ˨˩˦
đám	ʔ ɗ aː m ˦˧˥
đán	ʔ ɗ aː ŋ ˦˧˥
đáng	ʔ ɗ aː ŋ ˦˧˥
đánh	ʔ ɗ ɛ ɲ ˦˧˥
đáp	ʔ ɗ aː p̚ ˦˧˥
đát	ʔ ɗ aː k̚ ˦˧˥
đáy	ʔ ɗ a j ˨˩˦
đâm	ʔ ɗ ə m ˧˧
đâu	ʔ ɗ ə w ˧˧
đây	ʔ ɗ ə j ˧˧
đã	ʔ ɗ aː ˧˨
đãi	ʔ ɗ aː j ˧˨
đè	ʔ ɗ ɛ ˦˩
đèn	ʔ ɗ ɛ ŋ ˦˩
đèo	ʔ ɗ ɛ w ˦˩
đéo	ʔ ɗ ɛ w ˨˩˦
đê	ʔ ɗ e j ˧˧
đêm	ʔ ɗ e m ˧˧
đì	ʔ ɗ ɪ j ˦˩
đìa	ʔ ɗ i ə ˦˩
đình	ʔ ɗ ɨ n ˦˩
đía	ʔ ɗ i ə ˨˩˦
đích	ʔ ɗ ɨ t̚ ˦˧˥
đính	ʔ ɗ ɨ n ˦˧˥
đít	ʔ ɗ i t̚ ˦˧˥
đò	ʔ ɗ ɔ ˦˩
đòi	ʔ ɗ ɔ j ˦˩
đòm	ʔ ɗ ɔ m ˦˩
đòn	ʔ ɗ ɔ ŋ ˦˩
đó	ʔ ɗ ɔ ˨˩˦
đói	ʔ ɗ ɔ j ˨˩˦
đón	ʔ ɗ ɔ ŋ ˦˧˥
đóng	ʔ ɗ a w ŋ͡m ˦˧˥
đô	ʔ ɗ o w ˧˧
đôi	ʔ ɗ o j ˧˧
đông	ʔ ɗ ə w ŋ͡m ˧˧
đù	ʔ ɗ ʊ w ˦˩
đùa	ʔ ɗ u ə ˦˩
đùi	ʔ ɗ u j ˦˩
đùm	ʔ ɗ u m ˦˩
đùng	ʔ ɗ ʊ w ŋ͡m ˦˩
đú	ʔ ɗ ʊ w ˨˩˦
đúc	ʔ ɗ ʊ w k͡p̚ ˦˧˥
đúng	ʔ ɗ ʊ w ŋ͡m ˦˧˥
đúp	ʔ ɗ u p̚ ˦˧˥
đút	ʔ ɗ ʊ k̚ ˦˧˥
đăm	ʔ ɗ a m ˧˧
đăng	ʔ ɗ a ŋ ˧˧
đĩ	ʔ ɗ ɪ j ˧˨
đĩa	ʔ ɗ i ə ˧˨
đũa	ʔ ɗ u ə ˧˨
đũng	ʔ ɗ ʊ w ŋ͡m ˧˨
đũy	ʔ ɗ w ɪ j ˧˨
đơ	ʔ ɗ əː ˧˧
đơm	ʔ ɗ əː m ˧˧
đơn	ʔ ɗ əː ŋ ˧˧
đưa	ʔ ɗ ɨ ə ˧˧
đương	ʔ ɗ ɨ ə ŋ ˧˧
đước	ʔ ɗ ɨ ə k̚ ˦˧˥
đường	ʔ ɗ ɨ ə ŋ ˦˩
được	ʔ ɗ ɨ ə k̚ ˨˩ ʔ
đượm	ʔ ɗ ɨ ə m ˨˩ ʔ
đạc	ʔ ɗ aː k̚ ˨˩ ʔ
đại	ʔ ɗ aː j ˨˩ ʔ
đạm	ʔ ɗ aː m ˨˩ ʔ
đạn	ʔ ɗ aː ŋ ˨˩ ʔ
đạo	ʔ ɗ aː w ˨˩ ʔ
đạp	ʔ ɗ aː p̚ ˨˩ ʔ
đạt	ʔ ɗ aː k̚ ˨˩ ʔ
đả	ʔ ɗ aː ˧˨
đảm	ʔ ɗ aː m ˧˨
đảng	ʔ ɗ aː ŋ ˧˨
đảo	ʔ ɗ aː w ˧˨
đấm	ʔ ɗ ə m ˦˧˥
đấng	ʔ ɗ ə ŋ ˦˧˥
đất	ʔ ɗ ə k̚ ˦˧˥
đấu	ʔ ɗ ə w ˨˩˦
đấy	ʔ ɗ ə j ˨˩˦
đầm	ʔ ɗ ə m ˦˩
đần	ʔ ɗ ə ŋ ˦˩
đầu	ʔ ɗ ə w ˦˩
đầy	ʔ ɗ ə j ˦˩
đẩu	ʔ ɗ ə w ˧˨
đẩy	ʔ ɗ ə j ˧˨
đẫm	ʔ ɗ ə m ˧˨
đẫy	ʔ ɗ ə j ˧˨
đậm	ʔ ɗ ə m ˨˩ ʔ
đập	ʔ ɗ ə p̚ ˨˩ ʔ
đậu	ʔ ɗ ə w ˨˩ ʔ
đậy	ʔ ɗ ə j ˨˩ ʔ
đắm	ʔ ɗ a m ˦˧˥
đắng	ʔ ɗ a ŋ ˦˧˥
đắp	ʔ ɗ a p̚ ˦˧˥
đắt	ʔ ɗ a k̚ ˦˧˥
đằm	ʔ ɗ a m ˦˩
đằng	ʔ ɗ a ŋ ˦˩
đẳng	ʔ ɗ a ŋ ˧˨
đặc	ʔ ɗ a k̚ ˨˩ ʔ
đặng	ʔ ɗ a ŋ ˨˩ ʔ
đặt	ʔ ɗ a k̚ ˨˩ ʔ
đẹp	ʔ ɗ ɛ p̚ ˨˩ ʔ
đẹt	ʔ ɗ ɛ t̚ ˨˩ ʔ
đẻ	ʔ ɗ ɛ ˧˨
đẻn	ʔ ɗ ɛ ŋ ˧˨
đẽo	ʔ ɗ ɛ w ˧˨
đế	ʔ ɗ e j ˨˩˦
đếch	ʔ ɗ e t̚ ˦˧˥
đếm	ʔ ɗ e m ˦˧˥
đến	ʔ ɗ e n ˦˧˥
đề	ʔ ɗ e j ˦˩
đền	ʔ ɗ e n ˦˩
đều	ʔ ɗ e w ˦˩
để	ʔ ɗ e j ˧˨
đểu	ʔ ɗ e w ˧˨
đệ	ʔ ɗ e j ˨˩ ʔ
đệm	ʔ ɗ e m ˨˩ ʔ
đệt	ʔ ɗ e t̚ ˨˩ ʔ
đỉa	ʔ ɗ i ə ˧˨
đỉnh	ʔ ɗ ɨ n ˧˨
địch	ʔ ɗ ɨ t̚ ˨˩ ʔ
định	ʔ ɗ ɨ n ˨˩ ʔ
địt	ʔ ɗ i t̚ ˨˩ ʔ
đọ	ʔ ɗ ɔ ˨˩ ʔ
đọc	ʔ ɗ a w k͡p̚ ˨˩ ʔ
đọi	ʔ ɗ ɔ j ˨˩ ʔ
đọng	ʔ ɗ a w ŋ͡m ˨˩ ʔ
đọt	ʔ ɗ ɔ k̚ ˨˩ ʔ
đỏ	ʔ ɗ ɔ ˧˨
đỏm	ʔ ɗ ɔ m ˧˨
đố	ʔ ɗ o w ˨˩˦
đốc	ʔ ɗ ə w k͡p̚ ˦˧˥
đối	ʔ ɗ o j ˨˩˦
đốm	ʔ ɗ o m ˦˧˥
đốn	ʔ ɗ o ŋ ˦˧˥
đống	ʔ ɗ ə w ŋ͡m ˦˧˥
đốt	ʔ ɗ o k̚ ˦˧˥
đồ	ʔ ɗ o w ˦˩
đồi	ʔ ɗ o j ˦˩
đồn	ʔ ɗ o ŋ ˦˩
đồng	ʔ ɗ ə w ŋ͡m ˦˩
đổ	ʔ ɗ o w ˧˨
đổi	ʔ ɗ o j ˧˨
đỗ	ʔ ɗ o w ˧˨
đỗi	ʔ ɗ o j ˧˨
độ	ʔ ɗ o w ˨˩ ʔ
độc	ʔ ɗ ə w k͡p̚ ˨˩ ʔ
đội	ʔ ɗ o j ˨˩ ʔ
độn	ʔ ɗ o ŋ ˨˩ ʔ
động	ʔ ɗ ə w ŋ͡m ˨˩ ʔ
đột	ʔ ɗ o k̚ ˨˩ ʔ
đớ	ʔ ɗ əː ˨˩˦
đới	ʔ ɗ əː j ˨˩˦
đớn	ʔ ɗ əː ŋ ˦˧˥
đớp	ʔ ɗ əː p̚ ˦˧˥
đờ	ʔ ɗ əː ˦˩
đời	ʔ ɗ əː j ˦˩
đờm	ʔ ɗ əː m ˦˩
đờn	ʔ ɗ əː ŋ ˦˩
đỡ	ʔ ɗ əː ˧˨
đợi	ʔ ɗ əː j ˨˩ ʔ
đợt	ʔ ɗ əː k̚ ˨˩ ʔ
đụ	ʔ ɗ ʊ w ˨˩ ʔ
đục	ʔ ɗ ʊ w k͡p̚ ˨˩ ʔ
đụn	ʔ ɗ u n ˨˩ ʔ
đụng	ʔ ɗ ʊ w ŋ͡m ˨˩ ʔ
đụt	ʔ ɗ ʊ k̚ ˨˩ ʔ
đủ	ʔ ɗ ʊ w ˧˨
đứa	ʔ ɗ ɨ ə ˨˩˦
đức	ʔ ɗ ɨ k̚ ˦˧˥
đứng	ʔ ɗ ɨ ŋ ˦˧˥
đứt	ʔ ɗ ɨ k̚ ˦˧˥
đừng	ʔ ɗ ɨ ŋ ˦˩
đực	ʔ ɗ ɨ k̚ ˨˩ ʔ
đựng	ʔ ɗ ɨ ŋ ˨˩ ʔ
ơ	ʔ əː ˧˧
ơi	ʔ əː j ˧˧
ơn	ʔ əː ŋ ˧˧
ư	ʔ ɨ ˧˧
ưa	ʔ ɨ ə ˧˧
ưng	ʔ ɨ ŋ ˧˧
ươi	ʔ ɨ j ˧˧
ươn	ʔ ɨ ə ŋ ˧˧
ước	ʔ ɨ ə k̚ ˦˧˥
ướp	ʔ ɨ ə p̚ ˦˧˥
ướt	ʔ ɨ ə k̚ ˦˧˥
ạ	ʔ aː ˨˩ ʔ
ả	ʔ aː ˧˨
ải	ʔ aː j ˧˨
ảnh	ʔ ɛ ɲ ˧˨
ảo	ʔ aː w ˧˨
ấm	ʔ ə m ˦˧˥
ấn	ʔ ə ŋ ˦˧˥
ấp	ʔ ə p̚ ˦˧˥
ất	ʔ ə k̚ ˦˧˥
ấu	ʔ ə w ˨˩˦
ấy	ʔ ə j ˨˩˦
ầm	ʔ ə m ˦˩
ẩm	ʔ ə m ˧˨
ẩn	ʔ ə ŋ ˧˨
ẩu	ʔ ə w ˧˨
ập	ʔ ə p̚ ˨˩ ʔ
ắp	ʔ a p̚ ˦˧˥
ắt	ʔ a k̚ ˦˧˥
ẳng	ʔ a ŋ ˧˨
ẵm	ʔ a m ˧˨
ẹ	ʔ ɛ ˨˩ ʔ
ẹp	ʔ ɛ p̚ ˨˩ ʔ
ẻm	ʔ ɛ m ˧˨
ế	ʔ e j ˨˩˦
ếch	ʔ e t̚ ˦˧˥
ềnh	ʔ e n ˦˩
ễnh	ʔ e n ˧˨
ỉa	ʔ i ə ˧˨
ỉm	ʔ i m ˧˨
ỉn	ʔ i n ˧˨
ỉu	ʔ i w ˧˨
ị	ʔ ɪ j ˨˩ ʔ
ịch	ʔ ɨ t̚ ˨˩ ʔ
ịn	ʔ i n ˨˩ ʔ
ịt	ʔ i t̚ ˨˩ ʔ
ọe	ʔ w ɛ ˨˩ ʔ
ốc	ʔ ə w k͡p̚ ˦˧˥
ối	ʔ o j ˨˩˦
ốm	ʔ o m ˦˧˥
ống	ʔ ə w ŋ͡m ˦˧˥
ốp	ʔ o p̚ ˦˧˥
ồ	ʔ o w ˦˩
ồn	ʔ o ŋ ˦˩
ổ	ʔ o w ˧˨
ổi	ʔ o j ˧˨
ổn	ʔ o ŋ ˧˨
ổng	ʔ ə w ŋ͡m ˧˨
ộp	ʔ o p̚ ˨˩ ʔ
ớ	ʔ əː ˨˩˦
ớn	ʔ əː ŋ ˦˧˥
ớt	ʔ əː k̚ ˦˧˥
ờ	ʔ əː ˦˩
ở	ʔ əː ˧˨
ợ	ʔ əː ˨˩ ʔ
ụ	ʔ ʊ w ˨˩ ʔ
ủ	ʔ ʊ w ˧˨
ủa	ʔ u ə ˧˨
ủi	ʔ u j ˧˨
ủng	ʔ ʊ w ŋ͡m ˧˨
ứ	ʔ ɨ ˨˩˦
ứa	ʔ ɨ ə ˨˩˦
ức	ʔ ɨ k̚ ˦˧˥
ứng	ʔ ɨ ŋ ˦˧˥
ừ	ʔ ɨ ˦˩
ừa	ʔ ɨ ə ˦˩
ừm	ʔ ɨ m ˦˩
ửng	ʔ ɨ ŋ ˧˨
ực	ʔ ɨ k̚ ˨˩ ʔ
