ace	ʔ a j ŋ̟ ˧˧ t͡ɕ i ˧˨ ʔ ʔ ɛ m ˧˧
actini	ʔ aː k̚ ˧˦ t i ˧˧ n i ˧˧
adn	ʔ aː ˧˧ ʔ ɗ e ˧˧ ʔ ɛ n ˧˧
agon	ʔ aː ˧˧ ɣ ə w ŋ͡m ˧˧
ai	ʔ aː j ˧˧
alexanđê	ʔ aː ˧˧ l ɛ k̚ ˧˦ s aː n ˧˧ ʔ ɗ e ˧˧
am	ʔ aː m ˧˧
ambrôsiô	ʔ aː m ˧˧ ʔ ɓ ɹ o ˧˧ s i ˧˧ ʔ o ˧˧
amerixi	ʔ aː ˧˧ m e ˧˧ ɹ i ˧˧ s i ˧˧
amoni	ʔ aː ˧˧ m o ˧˧ n i ˧˧
an	ʔ aː n ˧˧
ancol	ʔ aː n ˧˧ k o n ˧˧
ang	ʔ aː ŋ ˧˧
anh	ʔ a j ŋ̟ ˧˧
anphongsô	ʔ aː n ˧˧ f a w ŋ͡m ˧˧ s o ˧˧
anphonsô	ʔ aː n ˧˧ f ɔ n ˧˧ s o ˧˧
anrê	ʔ aː n ˧˧ z e ˧˧
antimon	ʔ aː n ˧˧ t i ˧˧ m ɔ n ˧˧
antôn	ʔ aː n ˧˧ t o n ˧˧
anê	ʔ aː n ˧˧ n e ˧˧
ao	ʔ aː w ˧˧
asen	ʔ aː ˧˧ s ɛ n ˧˧
atatin	ʔ aː ˧˧ t aː ˧˧ t i n ˧˧
au	ʔ a w ˧˧
augustinô	ʔ a w ˧˧ ɣ u ˧˧ s t i n ˧˧ n o ˧˧
axit	ʔ aː ˧˧ s i t̚ ˧˦
axít	ʔ aː ˧˧ s i t̚ ˧˦
b	ʔ ɓ e ˧˧
ba	ʔ ɓ aː ˧˧
ban	ʔ ɓ aː n ˧˧
bang	ʔ ɓ aː ŋ ˧˧
banh	ʔ ɓ a j ŋ̟ ˧˧
bao	ʔ ɓ aː w ˧˧
bari	ʔ ɓ aː ˧˧ ɹ i ˧˧
batôlômêô	ʔ ɓ aː ˧˧ t o ˧˧ l o ˧˧ m e ˧˧ ʔ o ˧˧
bay	ʔ ɓ a j ˧˧
bazơ	ʔ ɓ aː ˧˧ z əː ˧˧
be	ʔ ɓ ɛ ˧˧
beckeli	ʔ ɓ ɛ k̚ ˧˦ k e ˧˧ l i ˧˧
beo	ʔ ɓ ɛ w ˧˧
beri	ʔ ɓ ɛ ˧˧ ɹ i ˧˧
berili	ʔ ɓ ɛ ˧˧ ɹ i ˧˧ l i ˧˧
bi	ʔ ɓ i ˧˧
bia	ʔ ɓ i ə ˧˧
binh	ʔ ɓ ï ŋ ˧˧
bismut	ʔ ɓ i t̚ ˧˧ m u t̚ ˧˧
bit	ʔ ɓ i t̚ ˧˧
bitmut	ʔ ɓ i t̚ ˧˧ m u t̚ ˧˧
biên	ʔ ɓ i ə n ˧˧
biếc	ʔ ɓ i ə k̚ ˧˦
biến	ʔ ɓ i ə n ˧˦
biếng	ʔ ɓ i ə ŋ ˧˦
biết	ʔ ɓ i ə t̚ ˧˦
biếu	ʔ ɓ i ə w ˧˦
biền	ʔ ɓ i ə n ˨˩
biển	ʔ ɓ i ə n ˧˩
biểu	ʔ ɓ i ə w ˧˩
biện	ʔ ɓ i ə n ˧˨ ʔ
biệt	ʔ ɓ i ə t̚ ˧˨ ʔ
blu	ʔ ɓ l u ˧˧
bo	ʔ ɓ ɔ ˧˧
boa	ʔ ɓ w aː ˧˧
bom	ʔ ɓ ɔ m ˧˧
bon	ʔ ɓ ɔ n ˧˧
bong	ʔ ɓ a w ŋ͡m ˧˧
boong	ʔ ɓ ɔ ŋ ˧˧
brigitta	ʔ ɓ ɹ i ˧˧ z i t̚ ˧˦ t aː ˧˧
brom	ʔ ɓ ɹ o m ˧˧
brâu	ʔ ɓ ɹ ə w ˧˧
bu	ʔ ɓ u ˧˧
bung	ʔ ɓ ʊ w ŋ͡m ˧˧
buôn	ʔ ɓ u ə n ˧˧
buông	ʔ ɓ u ə ŋ ˧˧
buýt	ʔ ɓ w i t̚ ˧˦
buốt	ʔ ɓ u ə t̚ ˧˦
buồi	ʔ ɓ u ə j ˨˩
buồm	ʔ ɓ u ə m ˨˩
buồn	ʔ ɓ u ə n ˨˩
buồng	ʔ ɓ u ə ŋ ˨˩
buổi	ʔ ɓ u ə j ˧˩
buộc	ʔ ɓ u ə k̚ ˧˨ ʔ
buột	ʔ ɓ u ə t̚ ˧˨ ʔ
bà	ʔ ɓ aː ˨˩
bài	ʔ ɓ aː j ˨˩
bàn	ʔ ɓ aː n ˨˩
bàng	ʔ ɓ aː ŋ ˨˩
bành	ʔ ɓ a j ŋ̟ ˨˩
bào	ʔ ɓ aː w ˨˩
bàu	ʔ ɓ a w ˨˩
bày	ʔ ɓ a j ˨˩
bá	ʔ ɓ aː ˧˦
bác	ʔ ɓ aː k̚ ˧˦
bách	ʔ ɓ a j k̟̚ ˧˦
bám	ʔ ɓ aː m ˧˦
bán	ʔ ɓ aː n ˧˦
báng	ʔ ɓ aː ŋ ˧˦
bánh	ʔ ɓ a j ŋ̟ ˧˦
báo	ʔ ɓ aː w ˧˦
bát	ʔ ɓ aː t̚ ˧˦
báu	ʔ ɓ a w ˧˦
bâu	ʔ ɓ ə w ˧˧
bây	ʔ ɓ ə j ˧˧
bã	ʔ ɓ aː ˦ˀ˥
bãi	ʔ ɓ aː j ˦ˀ˥
bão	ʔ ɓ aː w ˦ˀ˥
bè	ʔ ɓ ɛ ˨˩
bèn	ʔ ɓ ɛ n ˨˩
bèo	ʔ ɓ ɛ w ˨˩
bé	ʔ ɓ ɛ ˧˦
bén	ʔ ɓ ɛ n ˧˦
béo	ʔ ɓ ɛ w ˧˦
bét	ʔ ɓ ɛ t̚ ˧˦
bê	ʔ ɓ e ˧˧
bên	ʔ ɓ e n ˧˧
bênađô	ʔ ɓ e ˧˧ n aː ˧˧ ʔ ɗ o ˧˧
bênh	ʔ ɓ ə j ŋ̟ ˧˧
bênêđictô	ʔ ɓ e ˧˧ n e ˧˧ ʔ ɗ ï k̟̚ ˧˦ t o ˧˧
bêu	ʔ ɓ e w ˧˧
bì	ʔ ɓ i ˨˩
bìa	ʔ ɓ i ə ˨˩
bình	ʔ ɓ ï ŋ ˨˩
bìu	ʔ ɓ i w ˨˩
bí	ʔ ɓ i ˧˦
bích	ʔ ɓ ï k̟̚ ˧˦
bím	ʔ ɓ i m ˧˦
bính	ʔ ɓ ï ŋ ˧˦
bíp	ʔ ɓ i p̚ ˧˦
bít	ʔ ɓ i t̚ ˧˦
bíu	ʔ ɓ i w ˧˦
bò	ʔ ɓ ɔ ˨˩
bòn	ʔ ɓ ɔ n ˨˩
bó	ʔ ɓ ɔ ˧˦
bóc	ʔ ɓ a w k͡p̚ ˧˦
bói	ʔ ɓ ɔ j ˧˦
bón	ʔ ɓ ɔ n ˧˦
bóng	ʔ ɓ a w ŋ͡m ˧˦
bóp	ʔ ɓ ɔ p̚ ˧˦
bót	ʔ ɓ ɔ t̚ ˧˦
bô	ʔ ɓ o ˧˧
bôi	ʔ ɓ o j ˧˧
bôm	ʔ ɓ o m ˧˧
bông	ʔ ɓ ə w ŋ͡m ˧˧
bônifaciô	ʔ ɓ o n ˧˧ n i ˧˧ f aː ˧˧ s i ˧˧ ʔ o ˧˧
bõ	ʔ ɓ ɔ ˦ˀ˥
bù	ʔ ɓ u ˨˩
bùa	ʔ ɓ u ə ˨˩
bùi	ʔ ɓ u j ˨˩
bùm	ʔ ɓ u m ˨˩
bùn	ʔ ɓ u n ˨˩
bùng	ʔ ɓ ʊ w ŋ͡m ˨˩
bú	ʔ ɓ u ˧˦
búa	ʔ ɓ u ə ˧˦
búi	ʔ ɓ u j ˧˦
bún	ʔ ɓ u n ˧˦
búng	ʔ ɓ ʊ w ŋ͡m ˧˦
búp	ʔ ɓ u p̚ ˧˦
bút	ʔ ɓ u t̚ ˧˦
băm	ʔ ɓ a m ˧˧
băng	ʔ ɓ a ŋ ˧˧
bĩ	ʔ ɓ i ˦ˀ˥
bĩu	ʔ ɓ i w ˦ˀ˥
bơ	ʔ ɓ əː ˧˧
bơi	ʔ ɓ əː j ˧˧
bơm	ʔ ɓ əː m ˧˧
bư	ʔ ɓ ɨ ˧˧
bưng	ʔ ɓ ɨ ŋ ˧˧
bưu	ʔ ɓ i w ˧˧
bươi	ʔ ɓ ɨ ə j ˧˧
bươu	ʔ ɓ i ə w ˧˧
bước	ʔ ɓ ɨ ə k̚ ˧˦
bướm	ʔ ɓ ɨ ə m ˧˦
bướng	ʔ ɓ ɨ ə ŋ ˧˦
bướu	ʔ ɓ i ə w ˧˦
bưởi	ʔ ɓ ɨ ə j ˧˩
bạ	ʔ ɓ aː ˧˨ ʔ
bạc	ʔ ɓ aː k̚ ˧˨ ʔ
bạch	ʔ ɓ a j k̟̚ ˧˨ ʔ
bại	ʔ ɓ aː j ˧˨ ʔ
bạn	ʔ ɓ aː n ˧˨ ʔ
bạo	ʔ ɓ aː w ˧˨ ʔ
bạt	ʔ ɓ aː t̚ ˧˨ ʔ
bả	ʔ ɓ aː ˧˩
bản	ʔ ɓ aː n ˧˩
bảng	ʔ ɓ aː ŋ ˧˩
bảo	ʔ ɓ aː w ˧˩
bảy	ʔ ɓ a j ˧˩
bấm	ʔ ɓ ə m ˧˦
bất	ʔ ɓ ə t̚ ˧˦
bấu	ʔ ɓ ə w ˧˦
bấy	ʔ ɓ ə j ˧˦
bầm	ʔ ɓ ə m ˨˩
bần	ʔ ɓ ə n ˨˩
bầu	ʔ ɓ ə w ˨˩
bầy	ʔ ɓ ə j ˨˩
bẩm	ʔ ɓ ə m ˧˩
bẩn	ʔ ɓ ə n ˧˩
bẩy	ʔ ɓ ə j ˧˩
bẫy	ʔ ɓ ə j ˦ˀ˥
bậc	ʔ ɓ ə k̚ ˧˨ ʔ
bận	ʔ ɓ ə n ˧˨ ʔ
bật	ʔ ɓ ə t̚ ˧˨ ʔ
bậu	ʔ ɓ ə w ˧˨ ʔ
bậy	ʔ ɓ ə j ˧˨ ʔ
bắc	ʔ ɓ a k̚ ˧˦
bắn	ʔ ɓ a n ˧˦
bắp	ʔ ɓ a p̚ ˧˦
bắt	ʔ ɓ a t̚ ˧˦
bằm	ʔ ɓ a m ˨˩
bằng	ʔ ɓ a ŋ ˨˩
bẹ	ʔ ɓ ɛ ˧˨ ʔ
bẹn	ʔ ɓ ɛ n ˧˨ ʔ
bẹo	ʔ ɓ ɛ w ˧˨ ʔ
bẹp	ʔ ɓ ɛ p̚ ˧˨ ʔ
bẹt	ʔ ɓ ɛ t̚ ˧˨ ʔ
bẻ	ʔ ɓ ɛ ˧˩
bế	ʔ ɓ e ˧˦
bến	ʔ ɓ e n ˧˦
bếp	ʔ ɓ e p̚ ˧˦
bết	ʔ ɓ e t̚ ˧˦
bề	ʔ ɓ e ˨˩
bền	ʔ ɓ e n ˨˩
bể	ʔ ɓ e ˧˩
bển	ʔ ɓ e n ˧˩
bệ	ʔ ɓ e ˧˨ ʔ
bệch	ʔ ɓ ə j k̟̚ ˧˨ ʔ
bện	ʔ ɓ e n ˧˨ ʔ
bệnh	ʔ ɓ ə j ŋ̟ ˧˨ ʔ
bệt	ʔ ɓ e t̚ ˧˨ ʔ
bỉ	ʔ ɓ i ˧˩
bỉm	ʔ ɓ i m ˧˩
bị	ʔ ɓ i ˧˨ ʔ
bịa	ʔ ɓ i ə ˧˨ ʔ
bịch	ʔ ɓ ï k̟̚ ˧˨ ʔ
bịnh	ʔ ɓ ï ŋ ˧˨ ʔ
bịp	ʔ ɓ i p̚ ˧˨ ʔ
bịt	ʔ ɓ i t̚ ˧˨ ʔ
bọ	ʔ ɓ ɔ ˧˨ ʔ
bọc	ʔ ɓ a w k͡p̚ ˧˨ ʔ
bọn	ʔ ɓ ɔ n ˧˨ ʔ
bọng	ʔ ɓ a w ŋ͡m ˧˨ ʔ
bọt	ʔ ɓ ɔ t̚ ˧˨ ʔ
bỏ	ʔ ɓ ɔ ˧˩
bỏng	ʔ ɓ a w ŋ͡m ˧˩
bố	ʔ ɓ o ˧˦
bốc	ʔ ɓ ə w k͡p̚ ˧˦
bốn	ʔ ɓ o n ˧˦
bống	ʔ ɓ ə w ŋ͡m ˧˦
bốp	ʔ ɓ o p̚ ˧˦
bốt	ʔ ɓ o t̚ ˧˦
bồ	ʔ ɓ o ˨˩
bồi	ʔ ɓ o j ˨˩
bồn	ʔ ɓ o n ˨˩
bồng	ʔ ɓ ə w ŋ͡m ˨˩
bổ	ʔ ɓ o ˧˩
bổi	ʔ ɓ o j ˧˩
bổn	ʔ ɓ o n ˧˩
bổng	ʔ ɓ ə w ŋ͡m ˧˩
bỗng	ʔ ɓ ə w ŋ͡m ˦ˀ˥
bộ	ʔ ɓ o ˧˨ ʔ
bội	ʔ ɓ o j ˧˨ ʔ
bộng	ʔ ɓ ə w ŋ͡m ˧˨ ʔ
bột	ʔ ɓ o t̚ ˧˨ ʔ
bớ	ʔ ɓ əː ˧˦
bới	ʔ ɓ əː j ˧˦
bớp	ʔ ɓ əː p̚ ˧˦
bớt	ʔ ɓ əː t̚ ˧˦
bờ	ʔ ɓ əː ˨˩
bờm	ʔ ɓ əː m ˨˩
bở	ʔ ɓ əː ˧˩
bởi	ʔ ɓ əː j ˧˩
bỡn	ʔ ɓ əː n ˦ˀ˥
bợm	ʔ ɓ əː m ˧˨ ʔ
bụi	ʔ ɓ u j ˧˨ ʔ
bụm	ʔ ɓ u m ˧˨ ʔ
bụng	ʔ ɓ ʊ w ŋ͡m ˧˨ ʔ
bụt	ʔ ɓ u t̚ ˧˨ ʔ
bủa	ʔ ɓ u ə ˧˩
bứa	ʔ ɓ ɨ ə ˧˦
bức	ʔ ɓ ɨ k̚ ˧˦
bứng	ʔ ɓ ɨ ŋ ˧˦
bứt	ʔ ɓ ɨ t̚ ˧˦
bừa	ʔ ɓ ɨ ə ˨˩
bừng	ʔ ɓ ɨ ŋ ˨˩
bửa	ʔ ɓ ɨ ə ˧˩
bữa	ʔ ɓ ɨ ə ˦ˀ˥
bự	ʔ ɓ ɨ ˧˨ ʔ
bựa	ʔ ɓ ɨ ə ˧˨ ʔ
bực	ʔ ɓ ɨ k̚ ˧˨ ʔ
c	s e ˧˧
ca	k aː ˧˧
cacbon	k aː k̚ ˧˦ ʔ ɓ ɔ n ˧˧
cai	k aː j ˧˧
califoni	k aː ˧˧ l i ˧˧ f ɔ ˧˧ n i ˧˧
cam	k aː m ˧˧
can	k aː n ˧˧
canh	k a j ŋ̟ ˧˧
canxi	k aː n ˧˧ s i ˧˧
cao	k aː w ˧˧
catarina	k aː ˧˧ t aː ˧˧ z i n ˧˧ n aː ˧˧
cau	k a w ˧˧
cay	k a j ˧˧
cađimi	k aː ˧˧ ʔ ɗ i ˧˧ m i ˧˧
ch	s e ˧˧ h aː t̚ ˧˦
cha	t͡ɕ aː ˧˧
chai	t͡ɕ aː j ˧˧
chanh	t͡ɕ a j ŋ̟ ˧˧
chao	t͡ɕ aː w ˧˧
chau	t͡ɕ a w ˧˧
chay	t͡ɕ a j ˧˧
che	t͡ɕ ɛ ˧˧
chen	t͡ɕ ɛ n ˧˧
cheo	t͡ɕ ɛ w ˧˧
chi	t͡ɕ i ˧˧
chia	t͡ɕ i ə ˧˧
chim	t͡ɕ i m ˧˧
chinh	t͡ɕ ï ŋ ˧˧
chiêm	t͡ɕ i ə m ˧˧
chiên	t͡ɕ i ə n ˧˧
chiêng	t͡ɕ i ə ŋ ˧˧
chiêu	t͡ɕ i ə w ˧˧
chiếc	t͡ɕ i ə k̚ ˧˦
chiếm	t͡ɕ i ə m ˧˦
chiến	t͡ɕ i ə n ˧˦
chiếp	t͡ɕ i ə p̚ ˧˦
chiếu	t͡ɕ i ə w ˧˦
chiền	t͡ɕ i ə n ˨˩
chiều	t͡ɕ i ə w ˨˩
cho	t͡ɕ ɔ ˧˧
choa	t͡ɕ w aː ˧˧
choáng	t͡ɕ w aː ŋ ˧˦
choãi	t͡ɕ w aː j ˦ˀ˥
choét	t͡ɕ w ɛ t̚ ˧˦
choắt	t͡ɕ w a t̚ ˧˦
chu	t͡ɕ u ˧˧
chua	t͡ɕ u ə ˧˧
chui	t͡ɕ u j ˧˧
chum	t͡ɕ u m ˧˧
chung	t͡ɕ ʊ w ŋ͡m ˧˧
chuyên	t͡ɕ w i ə n ˧˧
chuyến	t͡ɕ w i ə n ˧˦
chuyền	t͡ɕ w i ə n ˨˩
chuyển	t͡ɕ w i ə n ˧˩
chuyện	t͡ɕ w i ə n ˧˨ ʔ
chuông	t͡ɕ u ə ŋ ˧˧
chuẩn	t͡ɕ w ə n ˧˩
chuốc	t͡ɕ u ə k̚ ˧˦
chuối	t͡ɕ u ə j ˧˦
chuốt	t͡ɕ u ə t̚ ˧˦
chuồn	t͡ɕ u ə n ˨˩
chuồng	t͡ɕ u ə ŋ ˨˩
chuỗi	t͡ɕ u ə j ˦ˀ˥
chuộc	t͡ɕ u ə k̚ ˧˨ ʔ
chuộng	t͡ɕ u ə ŋ ˧˨ ʔ
chuột	t͡ɕ u ə t̚ ˧˨ ʔ
chuỳ	t͡ɕ w i ˨˩
chxhcnvn	k ə w ŋ͡m ˧˨ ʔ h w aː ˨˩ s aː ˦ˀ˥ h o j ˧˨ ʔ t͡ɕ u ˧˩ ŋ i ə ˦ˀ˥ v i ə t̚ ˧˨ ʔ n aː m ˧˧
chà	t͡ɕ aː ˨˩
chài	t͡ɕ aː j ˨˩
chàm	t͡ɕ aː m ˨˩
chàng	t͡ɕ aː ŋ ˨˩
chào	t͡ɕ aː w ˨˩
chày	t͡ɕ a j ˨˩
chác	t͡ɕ aː k̚ ˧˦
chái	t͡ɕ aː j ˧˦
chán	t͡ɕ aː n ˧˦
chánh	t͡ɕ a j ŋ̟ ˧˦
cháo	t͡ɕ aː w ˧˦
chát	t͡ɕ aː t̚ ˧˦
cháu	t͡ɕ a w ˧˦
cháy	t͡ɕ a j ˧˦
châm	t͡ɕ ə m ˧˧
chân	t͡ɕ ə n ˧˧
châu	t͡ɕ ə w ˧˧
chão	t͡ɕ aː w ˦ˀ˥
chè	t͡ɕ ɛ ˨˩
chèn	t͡ɕ ɛ n ˨˩
chèo	t͡ɕ ɛ w ˨˩
ché	t͡ɕ ɛ ˧˦
chém	t͡ɕ ɛ m ˧˦
chén	t͡ɕ ɛ n ˧˦
chéo	t͡ɕ ɛ w ˧˦
chép	t͡ɕ ɛ p̚ ˧˦
chê	t͡ɕ e ˧˧
chêm	t͡ɕ e m ˧˧
chênh	t͡ɕ ə j ŋ̟ ˧˧
chì	t͡ɕ i ˨˩
chìa	t͡ɕ i ə ˨˩
chìm	t͡ɕ i m ˨˩
chí	t͡ɕ i ˧˦
chích	t͡ɕ ï k̟̚ ˧˦
chín	t͡ɕ i n ˧˦
chính	t͡ɕ ï ŋ ˧˦
chíp	t͡ɕ i p̚ ˧˦
chít	t͡ɕ i t̚ ˧˦
chòi	t͡ɕ ɔ j ˨˩
chòm	t͡ɕ ɔ m ˨˩
chó	t͡ɕ ɔ ˧˦
chói	t͡ɕ ɔ j ˧˦
chóng	t͡ɕ a w ŋ͡m ˧˦
chóp	t͡ɕ ɔ p̚ ˧˦
chót	t͡ɕ ɔ t̚ ˧˦
chôm	t͡ɕ o m ˧˧
chôn	t͡ɕ o n ˧˧
chông	t͡ɕ ə w ŋ͡m ˧˧
chõ	t͡ɕ ɔ ˦ˀ˥
chùa	t͡ɕ u ə ˨˩
chùi	t͡ɕ u j ˨˩
chùm	t͡ɕ u m ˨˩
chùn	t͡ɕ u n ˨˩
chú	t͡ɕ u ˧˦
chúa	t͡ɕ u ə ˧˦
chúc	t͡ɕ ʊ w k͡p̚ ˧˦
chúi	t͡ɕ u j ˧˦
chúng	t͡ɕ ʊ w ŋ͡m ˧˦
chút	t͡ɕ u t̚ ˧˦
chăm	t͡ɕ a m ˧˧
chăn	t͡ɕ a n ˧˧
chăng	t͡ɕ a ŋ ˧˧
chĩa	t͡ɕ i ə ˦ˀ˥
chơi	t͡ɕ əː j ˧˧
chưa	t͡ɕ ɨ ə ˧˧
chưng	t͡ɕ ɨ ŋ ˧˧
chương	t͡ɕ ɨ ə ŋ ˧˧
chước	t͡ɕ ɨ ə k̚ ˧˦
chướng	t͡ɕ ɨ ə ŋ ˧˦
chưởng	t͡ɕ ɨ ə ŋ ˧˩
chạc	t͡ɕ aː k̚ ˧˨ ʔ
chạm	t͡ɕ aː m ˧˨ ʔ
chạng	t͡ɕ aː ŋ ˧˨ ʔ
chạnh	t͡ɕ a j ŋ̟ ˧˨ ʔ
chạo	t͡ɕ aː w ˧˨ ʔ
chạp	t͡ɕ aː p̚ ˧˨ ʔ
chạy	t͡ɕ a j ˧˨ ʔ
chả	t͡ɕ aː ˧˩
chải	t͡ɕ aː j ˧˩
chảnh	t͡ɕ a j ŋ̟ ˧˩
chảo	t͡ɕ aː w ˧˩
chảy	t͡ɕ a j ˧˩
chấm	t͡ɕ ə m ˧˦
chấn	t͡ɕ ə n ˧˦
chấp	t͡ɕ ə p̚ ˧˦
chất	t͡ɕ ə t̚ ˧˦
chấy	t͡ɕ ə j ˧˦
chầu	t͡ɕ ə w ˨˩
chậc	t͡ɕ ə k̚ ˧˨ ʔ
chậm	t͡ɕ ə m ˧˨ ʔ
chập	t͡ɕ ə p̚ ˧˨ ʔ
chật	t͡ɕ ə t̚ ˧˨ ʔ
chậu	t͡ɕ ə w ˧˨ ʔ
chắc	t͡ɕ a k̚ ˧˦
chắn	t͡ɕ a n ˧˦
chắp	t͡ɕ a p̚ ˧˦
chắt	t͡ɕ a t̚ ˧˦
chằn	t͡ɕ a n ˨˩
chằng	t͡ɕ a ŋ ˨˩
chẳng	t͡ɕ a ŋ ˧˩
chẵn	t͡ɕ a n ˦ˀ˥
chặc	t͡ɕ a k̚ ˧˨ ʔ
chặn	t͡ɕ a n ˧˨ ʔ
chặng	t͡ɕ a ŋ ˧˨ ʔ
chặt	t͡ɕ a t̚ ˧˨ ʔ
chẹt	t͡ɕ ɛ t̚ ˧˨ ʔ
chẻ	t͡ɕ ɛ ˧˩
chẽn	t͡ɕ ɛ n ˦ˀ˥
chế	t͡ɕ e ˧˦
chết	t͡ɕ e t̚ ˧˦
chệch	t͡ɕ ə j k̟̚ ˧˨ ʔ
chỉ	t͡ɕ i ˧˩
chỉnh	t͡ɕ ï ŋ ˧˩
chị	t͡ɕ i ˧˨ ʔ
chịch	t͡ɕ ï k̟̚ ˧˨ ʔ
chịu	t͡ɕ i w ˧˨ ʔ
chọc	t͡ɕ a w k͡p̚ ˧˨ ʔ
chọi	t͡ɕ ɔ j ˧˨ ʔ
chọn	t͡ɕ ɔ n ˧˨ ʔ
chọt	t͡ɕ ɔ t̚ ˧˨ ʔ
chỏm	t͡ɕ ɔ m ˧˩
chốc	t͡ɕ ə w k͡p̚ ˧˦
chối	t͡ɕ o j ˧˦
chốn	t͡ɕ o n ˧˦
chống	t͡ɕ ə w ŋ͡m ˧˦
chốt	t͡ɕ o t̚ ˧˦
chồi	t͡ɕ o j ˨˩
chồm	t͡ɕ o m ˨˩
chồn	t͡ɕ o n ˨˩
chồng	t͡ɕ ə w ŋ͡m ˨˩
chổi	t͡ɕ o j ˧˩
chỗ	t͡ɕ o ˦ˀ˥
chộ	t͡ɕ o ˧˨ ʔ
chộp	t͡ɕ o p̚ ˧˨ ʔ
chột	t͡ɕ o t̚ ˧˨ ʔ
chớ	t͡ɕ əː ˧˦
chớm	t͡ɕ əː m ˧˦
chớp	t͡ɕ əː p̚ ˧˦
chờ	t͡ɕ əː ˨˩
chở	t͡ɕ əː ˧˩
chợ	t͡ɕ əː ˧˨ ʔ
chợp	t͡ɕ əː p̚ ˧˨ ʔ
chợt	t͡ɕ əː t̚ ˧˨ ʔ
chục	t͡ɕ ʊ w k͡p̚ ˧˨ ʔ
chụm	t͡ɕ u m ˧˨ ʔ
chụp	t͡ɕ u p̚ ˧˨ ʔ
chụt	t͡ɕ u t̚ ˧˨ ʔ
chủ	t͡ɕ u ˧˩
chủng	t͡ɕ ʊ w ŋ͡m ˧˩
chứ	t͡ɕ ɨ ˧˦
chứa	t͡ɕ ɨ ə ˧˦
chức	t͡ɕ ɨ k̚ ˧˦
chứng	t͡ɕ ɨ ŋ ˧˦
chứt	t͡ɕ ɨ t̚ ˧˦
chừ	t͡ɕ ɨ ˨˩
chừa	t͡ɕ ɨ ə ˨˩
chừng	t͡ɕ ɨ ŋ ˨˩
chử	t͡ɕ ɨ ˧˩
chửa	t͡ɕ ɨ ə ˧˩
chửi	t͡ɕ ɨ j ˧˩
chữ	t͡ɕ ɨ ˦ˀ˥
chữa	t͡ɕ ɨ ə ˦ˀ˥
chực	t͡ɕ ɨ k̚ ˧˨ ʔ
clb	k ə w ˧˧ l aː k̚ ˧˨ ʔ ʔ ɓ o ˧˨ ʔ
clo	k l ɔ ˧˧
clêmêntê	k l e ˧˧ m e n ˧˧ t e ˧˧
co	k ɔ ˧˧
coban	k o ˧˧ ʔ ɓ aː n ˧˧
cocktail	k o k̚ ˧˦ t a j ˧˧
coi	k ɔ j ˧˧
con	k ɔ n ˧˧
cong	k a w ŋ͡m ˧˧
constantinô	k ɔ n ˧˧ s t aː n ˧˧ t i n ˧˧ n o ˧˧
coronavirus	k ɔ ˧˧ z o ˧˧ n aː ˧˧ v i ˧˧ ɹ u t̚ ˧˦
cpcmltchmnvn	t͡ɕ ï ŋ ˧˦ f u ˧˩ k a j k̟̚ ˧˦ m aː ŋ ˧˨ ʔ l ə m ˧˧ tʰ əː j ˨˩ k ə w ŋ͡m ˧˨ ʔ h w aː ˨˩ m i ə n ˨˩ n aː m ˧˧ v i ə t̚ ˧˨ ʔ n aː m ˧˧
crom	k ɹ o m ˧˧
crôkê	k ɹ o ˧˧ k e ˧˧
csdl	k əː ˧˧ s əː ˧˩ z ɨ ˦ˀ˥ l i ə w ˧˨ ʔ
cttđvn	k aː k̚ ˧˦ tʰ a j ŋ̟ ˧˦ t ɨ ˧˩ ʔ ɗ aː w ˧˨ ʔ v i ə t̚ ˧˨ ʔ n aː m ˧˧
cu	k u ˧˧
cua	k u ə ˧˧
cumingtonit	k əː ˧˧ m ï ŋ ˧˧ t o ˧˧ n i t̚ ˧˦
cung	k ʊ w ŋ͡m ˧˧
curi	k u ˧˧ ɹ i ˧˧
cuốc	k u ə k̚ ˧˦
cuối	k u ə j ˧˦
cuốn	k u ə n ˧˦
cuống	k u ə ŋ ˧˦
cuồng	k u ə ŋ ˨˩
cuộc	k u ə k̚ ˧˨ ʔ
cuội	k u ə j ˧˨ ʔ
cuộn	k u ə n ˧˨ ʔ
cà	k aː ˨˩
cài	k aː j ˨˩
càn	k aː n ˨˩
càng	k aː ŋ ˨˩
cành	k a j ŋ̟ ˨˩
cào	k aː w ˨˩
cày	k a j ˨˩
cá	k aː ˧˦
các	k aː k̚ ˧˦
cách	k a j k̟̚ ˧˦
cái	k aː j ˧˦
cám	k aː m ˧˦
cán	k aː n ˧˦
cáng	k aː ŋ ˧˦
cánh	k a j ŋ̟ ˧˦
cáo	k aː w ˧˦
cáp	k aː p̚ ˧˦
cát	k aː t̚ ˧˦
cáu	k a w ˧˦
cáy	k a j ˧˦
câm	k ə m ˧˧
cân	k ə n ˧˧
câng	k ə ŋ ˧˧
câu	k ə w ˧˧
cây	k ə j ˧˧
cãi	k aː j ˦ˀ˥
cò	k ɔ ˨˩
còi	k ɔ j ˨˩
còm	k ɔ m ˨˩
còn	k ɔ n ˨˩
còng	k a w ŋ͡m ˨˩
có	k ɔ ˧˦
cóc	k a w k͡p̚ ˧˦
cói	k ɔ j ˧˦
cóng	k a w ŋ͡m ˧˦
cót	k ɔ t̚ ˧˦
cô	k o ˧˧
côi	k o j ˧˧
côn	k o n ˧˧
công	k ə w ŋ͡m ˧˧
côngxoocxiom	k ə w ŋ͡m ˧˧ s ɔ k̚ ˧˦ s i ˧˧ ʔ ɔ m ˧˧
côrnêliô	k o ˧˧ n e ˧˧ l i ˧˧ ʔ o ˧˧
côsin	k o ˧˧ s i n ˧˧
côtang	k o ˧˧ t aː ŋ ˧˧
cõi	k ɔ j ˦ˀ˥
cõng	k a w ŋ͡m ˦ˀ˥
cù	k u ˨˩
cùi	k u j ˨˩
cùm	k u m ˨˩
cùn	k u n ˨˩
cùng	k ʊ w ŋ͡m ˨˩
cú	k u ˧˦
cúc	k ʊ w k͡p̚ ˧˦
cúi	k u j ˧˦
cúm	k u m ˧˦
cún	k u n ˧˦
cúng	k ʊ w ŋ͡m ˧˦
cúp	k u p̚ ˧˦
cút	k u t̚ ˧˦
căm	k a m ˧˧
căn	k a n ˧˧
căng	k a ŋ ˧˧
cđ	k aː w ˧˧ ʔ ɗ a ŋ ˧˩
cđ	k ə w ŋ͡m ˧˨ ʔ ʔ ɗ ə w ŋ͡m ˨˩
cũ	k u ˦ˀ˥
cũi	k u j ˦ˀ˥
cũng	k ʊ w ŋ͡m ˦ˀ˥
cơ	k əː ˧˧
cơi	k əː j ˧˧
cơm	k əː m ˧˧
cơn	k əː n ˧˧
cư	k ɨ ˧˧
cưa	k ɨ ə ˧˧
cưng	k ɨ ŋ ˧˧
cươi	k ɨ ə j ˧˧
cương	k ɨ ə ŋ ˧˧
cước	k ɨ ə k̚ ˧˦
cưới	k ɨ ə j ˧˦
cướp	k ɨ ə p̚ ˧˦
cười	k ɨ ə j ˨˩
cườm	k ɨ ə m ˨˩
cường	k ɨ ə ŋ ˨˩
cưỡi	k ɨ ə j ˦ˀ˥
cưỡng	k ɨ ə ŋ ˦ˀ˥
cược	k ɨ ə k̚ ˧˨ ʔ
cạ	k aː ˧˨ ʔ
cạc	k aː k̚ ˧˨ ʔ
cạch	k a j k̟̚ ˧˨ ʔ
cạm	k aː m ˧˨ ʔ
cạn	k aː n ˧˨ ʔ
cạnh	k a j ŋ̟ ˧˨ ʔ
cạo	k aː w ˧˨ ʔ
cạp	k aː p̚ ˧˨ ʔ
cạy	k a j ˧˨ ʔ
cả	k aː ˧˩
cải	k aː j ˧˩
cảm	k aː m ˧˩
cản	k aː n ˧˩
cảng	k aː ŋ ˧˩
cảnh	k a j ŋ̟ ˧˩
cấm	k ə m ˧˦
cấp	k ə p̚ ˧˦
cất	k ə t̚ ˧˦
cấu	k ə w ˧˦
cấy	k ə j ˧˦
cầm	k ə m ˨˩
cần	k ə n ˨˩
cầu	k ə w ˨˩
cầy	k ə j ˨˩
cẩm	k ə m ˧˩
cẩu	k ə w ˧˩
cận	k ə n ˧˨ ʔ
cật	k ə t̚ ˧˨ ʔ
cậu	k ə w ˧˨ ʔ
cậy	k ə j ˧˨ ʔ
cắc	k a k̚ ˧˦
cắm	k a m ˧˦
cắn	k a n ˧˦
cắp	k a p̚ ˧˦
cắt	k a t̚ ˧˦
cằm	k a m ˨˩
cẳng	k a ŋ ˧˩
cặc	k a k̚ ˧˨ ʔ
cặn	k a n ˧˨ ʔ
cặp	k a p̚ ˧˨ ʔ
cọ	k ɔ ˧˨ ʔ
cọc	k a w k͡p̚ ˧˨ ʔ
cọng	k a w ŋ͡m ˧˨ ʔ
cọp	k ɔ p̚ ˧˨ ʔ
cỏ	k ɔ ˧˩
cố	k o ˧˦
cốc	k ə w k͡p̚ ˧˦
cối	k o j ˧˦
cốm	k o m ˧˦
cống	k ə w ŋ͡m ˧˦
cốp	k o p̚ ˧˦
cốt	k o t̚ ˧˦
cồn	k o n ˨˩
cồng	k ə w ŋ͡m ˨˩
cổ	k o ˧˩
cổng	k ə w ŋ͡m ˧˩
cỗ	k o ˦ˀ˥
cỗi	k o j ˦ˀ˥
cộ	k o ˧˨ ʔ
cội	k o j ˧˨ ʔ
cộm	k o m ˧˨ ʔ
cộng	k ə w ŋ͡m ˧˨ ʔ
cột	k o t̚ ˧˨ ʔ
cớ	k əː ˧˦
cớm	k əː m ˧˦
cờ	k əː ˨˩
cởi	k əː j ˧˩
cỡ	k əː ˦ˀ˥
cỡi	k əː j ˦ˀ˥
cụ	k u ˧˨ ʔ
cục	k ʊ w k͡p̚ ˧˨ ʔ
cụm	k u m ˧˨ ʔ
cụng	k ʊ w ŋ͡m ˧˨ ʔ
cụp	k u p̚ ˧˨ ʔ
cụt	k u t̚ ˧˨ ʔ
củ	k u ˧˩
của	k u ə ˧˩
củi	k u j ˧˩
cứ	k ɨ ˧˦
cứa	k ɨ ə ˧˦
cứng	k ɨ ŋ ˧˦
cứt	k ɨ t̚ ˧˦
cứu	k i w ˧˦
cừu	k i w ˨˩
cử	k ɨ ˧˩
cửa	k ɨ ə ˧˩
cửi	k ɨ j ˧˩
cửu	k i w ˧˩
cự	k ɨ ˧˨ ʔ
cựa	k ɨ ə ˧˨ ʔ
cực	k ɨ k̚ ˧˨ ʔ
cựu	k i w ˧˨ ʔ
d	z e ˧˧
da	z aː ˧˧
dai	z aː j ˧˧
dam	z aː m ˧˧
dang	z aː ŋ ˧˧
danh	z a j ŋ̟ ˧˧
dao	z aː w ˧˧
decimet	ʔ ɗ e ˧˧ s i ˧˧ m ɛ t̚ ˧˦
dinh	z ï ŋ ˧˧
diêm	z i ə m ˧˧
diếp	z i ə p̚ ˧˦
diều	z i ə w ˨˩
diễn	z i ə n ˦ˀ˥
diệc	z i ə k̚ ˧˨ ʔ
diện	z i ə n ˧˨ ʔ
diệp	z i ə p̚ ˧˨ ʔ
diệt	z i ə t̚ ˧˨ ʔ
diệu	z i ə w ˧˨ ʔ
do	z ɔ ˧˧
dom	z ɔ m ˧˧
don	z ɔ n ˧˧
dong	z a w ŋ͡m ˧˧
doạ	z w aː ˧˨ ʔ
du	z u ˧˧
dung	z ʊ w ŋ͡m ˧˧
duy	z w i ˧˧
duyên	z w i ə n ˧˧
duyệt	z w i ə t̚ ˧˨ ʔ
duối	z u ə j ˧˦
duỗi	z u ə j ˦ˀ˥
dzô	z o ˧˧
dài	z aː j ˨˩
dàn	z aː n ˨˩
dành	z a j ŋ̟ ˨˩
dày	z a j ˨˩
dái	z aː j ˧˦
dám	z aː m ˧˦
dán	z aː n ˧˦
dáng	z aː ŋ ˧˦
dâm	z ə m ˧˧
dân	z ə n ˧˧
dâng	z ə ŋ ˧˧
dâu	z ə w ˧˧
dây	z ə j ˧˧
dã	z aː ˦ˀ˥
dãi	z aː j ˦ˀ˥
dãn	z aː n ˦ˀ˥
dãy	z a j ˦ˀ˥
dè	z ɛ ˨˩
dép	z ɛ p̚ ˧˦
dét	z ɛ t̚ ˧˦
dê	z e ˧˧
dì	z i ˨˩
dìm	z i m ˨˩
dìu	z i w ˨˩
dí	z i ˧˦
dím	z i m ˧˦
dính	z ï ŋ ˧˦
dò	z ɔ ˨˩
dòm	z ɔ m ˨˩
dòng	z a w ŋ͡m ˨˩
dóc	z a w k͡p̚ ˧˦
dóm	z ɔ m ˧˦
dô	z o ˧˧
dông	z ə w ŋ͡m ˧˧
dõi	z ɔ j ˦ˀ˥
dù	z u ˨˩
dùi	z u j ˨˩
dùm	z u m ˨˩
dùng	z ʊ w ŋ͡m ˨˩
dúi	z u j ˧˦
dúm	z u m ˧˦
dăm	z a m ˧˧
dĩ	z i ˦ˀ˥
dĩa	z i ə ˦ˀ˥
dũng	z ʊ w ŋ͡m ˦ˀ˥
dơ	z əː ˧˧
dơi	z əː j ˧˧
dư	z ɨ ˧˧
dưa	z ɨ ə ˧˧
dưng	z ɨ ŋ ˧˧
dương	z ɨ ə ŋ ˧˧
dưới	z ɨ ə j ˧˦
dường	z ɨ ə ŋ ˨˩
dưỡng	z ɨ ə ŋ ˦ˀ˥
dược	z ɨ ə k̚ ˧˨ ʔ
dượng	z ɨ ə ŋ ˧˨ ʔ
dượt	z ɨ ə t̚ ˧˨ ʔ
dạ	z aː ˧˨ ʔ
dại	z aː j ˧˨ ʔ
dạn	z aː n ˧˨ ʔ
dạng	z aː ŋ ˧˨ ʔ
dạo	z aː w ˧˨ ʔ
dạy	z a j ˧˨ ʔ
dải	z aː j ˧˩
dấn	z ə n ˧˦
dấu	z ə w ˧˦
dấy	z ə j ˧˦
dầm	z ə m ˨˩
dần	z ə n ˨˩
dầu	z ə w ˨˩
dẫn	z ə n ˦ˀ˥
dẫu	z ə w ˦ˀ˥
dậm	z ə m ˧˨ ʔ
dập	z ə p̚ ˧˨ ʔ
dậu	z ə w ˧˨ ʔ
dậy	z ə j ˧˨ ʔ
dắt	z a t̚ ˧˦
dằm	z a m ˨˩
dằn	z a n ˨˩
dặm	z a m ˧˨ ʔ
dặn	z a n ˧˨ ʔ
dẹp	z ɛ p̚ ˧˨ ʔ
dẹt	z ɛ t̚ ˧˨ ʔ
dẻ	z ɛ ˧˩
dẻo	z ɛ w ˧˩
dẽ	z ɛ ˦ˀ˥
dế	z e ˧˦
dền	z e n ˨˩
dễ	z e ˦ˀ˥
dệt	z e t̚ ˧˨ ʔ
dịch	z ï k̟̚ ˧˨ ʔ
dịp	z i p̚ ˧˨ ʔ
dịu	z i w ˧˨ ʔ
dọc	z a w k͡p̚ ˧˨ ʔ
dọn	z ɔ n ˧˨ ʔ
dỏ	z ɔ ˧˩
dỏm	z ɔ m ˧˩
dốc	z ə w k͡p̚ ˧˦
dối	z o j ˧˦
dốt	z o t̚ ˧˦
dồi	z o j ˨˩
dồn	z o n ˨˩
dỗ	z o ˦ˀ˥
dỗi	z o j ˦ˀ˥
dộc	z ə w k͡p̚ ˧˨ ʔ
dội	z o j ˧˨ ʔ
dộng	z ə w ŋ͡m ˧˨ ʔ
dột	z o t̚ ˧˨ ʔ
dớp	z əː p̚ ˧˦
dớt	z əː t̚ ˧˦
dời	z əː j ˨˩
dở	z əː ˧˩
dởm	z əː m ˧˩
dỡ	z əː ˦ˀ˥
dợm	z əː m ˧˨ ʔ
dụ	z u ˧˨ ʔ
dục	z ʊ w k͡p̚ ˧˨ ʔ
dụng	z ʊ w ŋ͡m ˧˨ ʔ
dứa	z ɨ ə ˧˦
dức	z ɨ k̚ ˧˦
dứt	z ɨ t̚ ˧˦
dừa	z ɨ ə ˨˩
dừng	z ɨ ŋ ˨˩
dử	z ɨ ˧˩
dửng	z ɨ ŋ ˧˩
dữ	z ɨ ˦ˀ˥
dự	z ɨ ˧˨ ʔ
dựa	z ɨ ə ˧˨ ʔ
dựng	z ɨ ŋ ˧˨ ʔ
e	ʔ ɛ ˧˧
electron	ʔ ɛ ˧˧ l ɛ k̚ ˧˦ t͡ɕ ə w ŋ͡m ˧˧
elip	ʔ ɛ ˧˧ l i p̚ ˧˦
em	ʔ ɛ m ˧˧
ensteni	ʔ ɛ n ˧˧ s t ɛ ˧˧ n i ˧˧
eo	ʔ ɛ w ˧˧
eribi	ʔ ɛ ˧˧ ɹ i ˧˧ ʔ ɓ i ˧˧
eu	ʔ ɛ ˧˧ ʔ u ˧˧
europi	ʔ e w ˧˧ ɹ o ˧˧ p i ˧˧
fa	ʔ ɛ p̚ ˧˦ f əː ˨˩ ʔ aː ˧˧
fara	f aː ˧˧ z aː ˧˧
fecmi	f ɛ k̚ ˧˦ m i ˧˧
flerovi	f l e ˧˧ ɹ ɔ ˧˧ v i ˧˧
flo	f l ɔ ˧˧
franxi	f ɹ aː n ˧˧ s i ˧˧
fêlix	f e ˧˧ l ï k̟̚ ˧˦
g	z e ˧˧
g	ɣ əː ˨˩
ga	ɣ aː ˧˧
gai	ɣ aː j ˧˧
gali	ɣ aː ˧˧ l i ˧˧
gam	ɣ aː m ˧˧
gan	ɣ aː n ˧˧
gang	ɣ aː ŋ ˧˧
ganh	ɣ a j ŋ̟ ˧˧
gato	ɣ aː ˧˧ t ɔ ˧˧
gay	ɣ a j ˧˧
gađolini	ɣ aː ˧˧ ʔ ɗ o ˧˧ l i ˧˧ n i ˧˧
gemani	z ɛ ˧˧ m aː ˧˧ n i ˧˧
gen	z ɛ n ˧˧
ghe	ɣ ɛ ˧˧
ghen	ɣ ɛ n ˧˧
ghi	ɣ i ˧˧
ghim	ɣ i m ˧˧
ghiền	ɣ i ə n ˨˩
ghè	ɣ ɛ ˨˩
ghèn	ɣ ɛ n ˨˩
ghé	ɣ ɛ ˧˦
ghép	ɣ ɛ p̚ ˧˦
ghét	ɣ ɛ t̚ ˧˦
ghê	ɣ e ˧˧
ghì	ɣ i ˨˩
ghìm	ɣ i m ˨˩
ghẹ	ɣ ɛ ˧˨ ʔ
ghẹo	ɣ ɛ w ˧˨ ʔ
ghẻ	ɣ ɛ ˧˩
ghế	ɣ e ˧˦
ghệ	ɣ e ˧˨ ʔ
ghệt	ɣ e t̚ ˧˨ ʔ
gi	z i ˧˧
gia	z aː ˧˧
giacôbê	z aː ˧˧ k o ˧˧ ʔ ɓ e ˧˧
giai	z aː j ˧˧
giam	z aː m ˧˧
gian	z aː n ˧˧
giang	z aː ŋ ˧˧
giao	z aː w ˧˧
gieo	z ɛ w ˧˧
gio	z ɔ ˧˧
gioan	z w aː n ˧˧
giong	z a w ŋ͡m ˧˧
giuliô	z u ˧˧ l i ˧˧ ʔ o ˧˧
giun	z u n ˧˧
giuse	z u ˧˧ s ɛ ˧˧
giuđa	z u ˧˧ ʔ ɗ aː ˧˧
giuộc	z u ə k̚ ˧˨ ʔ
già	z aː ˨˩
giàn	z aː n ˨˩
giàng	z aː ŋ ˨˩
giành	z a j ŋ̟ ˨˩
giàu	z a w ˨˩
giày	z a j ˨˩
giá	z aː ˧˦
giác	z aː k̚ ˧˦
gián	z aː n ˧˦
giáng	z aː ŋ ˧˦
giáo	z aː w ˧˦
giáp	z aː p̚ ˧˦
giáy	z a j ˧˦
giâm	z ə m ˧˧
giây	z ə j ˧˧
giã	z aː ˦ˀ˥
giãi	z aː j ˦ˀ˥
giãn	z aː n ˦ˀ˥
giãy	z a j ˦ˀ˥
gié	z ɛ ˧˦
giê	z e ˧˧
giêng	z i ə ŋ ˧˧
giêsu	z e ˧˧ s u ˧˧
giò	z ɔ ˨˩
giòi	z ɔ j ˨˩
giòn	z ɔ n ˨˩
gió	z ɔ ˧˦
gióc	z a w k͡p̚ ˧˦
gióng	z a w ŋ͡m ˧˦
giông	z ə w ŋ͡m ˧˧
giùi	z u j ˨˩
giùm	z u m ˨˩
giú	z u ˧˦
giúp	z u p̚ ˧˦
giăm	z a m ˧˧
giăng	z a ŋ ˧˧
giũ	z u ˦ˀ˥
giũa	z u ə ˦ˀ˥
giơ	z əː ˧˧
giương	z ɨ ə ŋ ˧˧
giường	z ɨ ə ŋ ˨˩
giạng	z aː ŋ ˧˨ ʔ
giạt	z aː t̚ ˧˨ ʔ
giả	z aː ˧˩
giải	z aː j ˧˩
giảm	z aː m ˧˩
giảng	z aː ŋ ˧˩
giảnh	z a j ŋ̟ ˧˩
giảo	z aː w ˧˩
giấc	z ə k̚ ˧˦
giấm	z ə m ˧˦
giấu	z ə w ˧˦
giấy	z ə j ˧˦
giầm	z ə m ˨˩
giầu	z ə w ˨˩
giầy	z ə j ˨˩
giẫm	z ə m ˦ˀ˥
giậm	z ə m ˧˨ ʔ
giận	z ə n ˧˨ ʔ
giập	z ə p̚ ˧˨ ʔ
giật	z ə t̚ ˧˨ ʔ
giậu	z ə w ˧˨ ʔ
giằm	z a m ˨˩
giặc	z a k̚ ˧˨ ʔ
giặt	z a t̚ ˧˨ ʔ
giẹp	z ɛ p̚ ˧˨ ʔ
giẻ	z ɛ ˧˩
giếm	z i ə m ˧˦
giếng	z i ə ŋ ˧˦
giết	z i ə t̚ ˧˦
giền	z e n ˨˩
giềng	z i ə ŋ ˨˩
giễu	z i ə w ˦ˀ˥
giọi	z ɔ j ˧˨ ʔ
giọng	z a w ŋ͡m ˧˨ ʔ
giọt	z ɔ t̚ ˧˨ ʔ
giỏ	z ɔ ˧˩
giỏi	z ɔ j ˧˩
giống	z ə w ŋ͡m ˧˦
giồng	z ə w ŋ͡m ˨˩
giỗ	z o ˦ˀ˥
giội	z o j ˧˨ ʔ
giới	z əː j ˧˦
giờ	z əː ˨˩
giời	z əː j ˨˩
giở	z əː ˧˩
giỡn	z əː n ˦ˀ˥
giục	z ʊ w k͡p̚ ˧˨ ʔ
giụi	z u j ˧˨ ʔ
giừ	z ɨ ˨˩
giữ	z ɨ ˦ˀ˥
giữa	z ɨ ə ˦ˀ˥
giựt	z ɨ t̚ ˧˨ ʔ
go	ɣ ɔ ˧˧
golf	ɣ o n ˧˧
gom	ɣ ɔ m ˧˧
goá	ɣ w aː ˧˦
grêgôriô	z e ˧˧ ɣ o ˧˧ z i ˧˧ ʔ o ˧˧
gu	ɣ u ˧˧
guốc	ɣ u ə k̚ ˧˦
guồng	ɣ u ə ŋ ˨˩
gà	ɣ aː ˨˩
gài	ɣ aː j ˨˩
gàn	ɣ aː n ˨˩
gào	ɣ aː w ˨˩
gàu	ɣ a w ˨˩
gác	ɣ aː k̚ ˧˦
gái	ɣ aː j ˧˦
gán	ɣ aː n ˧˦
gánh	ɣ a j ŋ̟ ˧˦
gáo	ɣ aː w ˧˦
gáy	ɣ a j ˧˦
gân	ɣ ə n ˧˧
gâu	ɣ ə w ˧˧
gây	ɣ ə j ˧˧
gã	ɣ aː ˦ˀ˥
gãi	ɣ aː j ˦ˀ˥
gãy	ɣ a j ˦ˀ˥
gì	z i ˨˩
gìn	z i n ˨˩
gò	ɣ ɔ ˨˩
góc	ɣ a w k͡p̚ ˧˦
gói	ɣ ɔ j ˧˦
góp	ɣ ɔ p̚ ˧˦
gót	ɣ ɔ t̚ ˧˦
gôm	ɣ o m ˧˧
gôn	ɣ o n ˧˧
gông	ɣ ə w ŋ͡m ˧˧
gõ	ɣ ɔ ˦ˀ˥
gù	ɣ u ˨˩
gùi	ɣ u j ˨˩
gút	ɣ u t̚ ˧˦
găm	ɣ a m ˧˧
găng	ɣ a ŋ ˧˧
gươm	ɣ ɨ ə m ˧˧
gương	ɣ ɨ ə ŋ ˧˧
gượm	ɣ ɨ ə m ˧˨ ʔ
gượng	ɣ ɨ ə ŋ ˧˨ ʔ
gạ	ɣ aː ˧˨ ʔ
gạc	ɣ aː k̚ ˧˨ ʔ
gạch	ɣ a j k̟̚ ˧˨ ʔ
gạo	ɣ aː w ˧˨ ʔ
gạt	ɣ aː t̚ ˧˨ ʔ
gả	ɣ aː ˧˩
gảy	ɣ a j ˧˩
gấc	ɣ ə k̚ ˧˦
gấm	ɣ ə m ˧˦
gấp	ɣ ə p̚ ˧˦
gấu	ɣ ə w ˧˦
gấy	ɣ ə j ˧˦
gầm	ɣ ə m ˨˩
gần	ɣ ə n ˨˩
gầy	ɣ ə j ˨˩
gẫm	ɣ ə m ˦ˀ˥
gập	ɣ ə p̚ ˧˨ ʔ
gật	ɣ ə t̚ ˧˨ ʔ
gậy	ɣ ə j ˧˨ ʔ
gắn	ɣ a n ˧˦
gắng	ɣ a ŋ ˧˦
gắp	ɣ a p̚ ˧˦
gắt	ɣ a t̚ ˧˦
gằn	ɣ a n ˨˩
gặm	ɣ a m ˧˨ ʔ
gặng	ɣ a ŋ ˧˨ ʔ
gặp	ɣ a p̚ ˧˨ ʔ
gặt	ɣ a t̚ ˧˨ ʔ
gỉ	z i ˧˩
gọi	ɣ ɔ j ˧˨ ʔ
gọn	ɣ ɔ n ˧˨ ʔ
gọng	ɣ a w ŋ͡m ˧˨ ʔ
gọt	ɣ ɔ t̚ ˧˨ ʔ
gỏi	ɣ ɔ j ˧˩
gốc	ɣ ə w k͡p̚ ˧˦
gối	ɣ o j ˧˦
gốm	ɣ o m ˧˦
gồm	ɣ o m ˨˩
gồng	ɣ ə w ŋ͡m ˨˩
gỗ	ɣ o ˦ˀ˥
gộc	ɣ ə w k͡p̚ ˧˨ ʔ
gội	ɣ o j ˧˨ ʔ
gộp	ɣ o p̚ ˧˨ ʔ
gớm	ɣ əː m ˧˦
gờ	ɣ əː ˨˩
gờm	ɣ əː m ˨˩
gở	ɣ əː ˧˩
gởi	ɣ əː j ˧˩
gỡ	ɣ əː ˦ˀ˥
gợi	ɣ əː j ˧˨ ʔ
gợn	ɣ əː n ˧˨ ʔ
gục	ɣ ʊ w k͡p̚ ˧˨ ʔ
gừng	ɣ ɨ ŋ ˨˩
gửi	ɣ ɨ j ˧˩
h	h a t̚ ˧˦
h'mông	h əː ˨˩ m ə w ŋ͡m ˧˧
ha	h aː ˧˧
hafini	h aː ˧˧ f i ˧˧ n i ˧˧
hai	h aː j ˧˧
ham	h aː m ˧˧
hang	h aː ŋ ˧˧
hao	h aː w ˧˧
hay	h a j ˧˧
heli	h e ˧˧ l i ˧˧
hen	h ɛ n ˧˧
heo	h ɛ w ˧˧
hi	h i ˧˧
hia	h i ə ˧˧
hic	h ï k̟̚ ˧˦
hilariô	h i ˧˧ l aː ˧˧ z i ˧˧ ʔ o ˧˧
hiu	h i w ˧˧
hiên	h i ə n ˧˧
hiđro	h i ˧˧ ʔ ɗ ɹ o ˧˧
hiếm	h i ə m ˧˦
hiến	h i ə n ˧˦
hiếp	h i ə p̚ ˧˦
hiếu	h i ə w ˧˦
hiền	h i ə n ˨˩
hiểm	h i ə m ˧˩
hiển	h i ə n ˧˩
hiểu	h i ə w ˧˩
hiện	h i ə n ˧˨ ʔ
hiệp	h i ə p̚ ˧˨ ʔ
hiệu	h i ə w ˧˨ ʔ
ho	h ɔ ˧˧
hoa	h w aː ˧˧
hoang	h w aː ŋ ˧˧
hoen	h w ɛ n ˧˧
hoi	h ɔ j ˧˧
hong	h a w ŋ͡m ˧˧
honmi	h o n ˧˧ m i ˧˧
hoà	h w aː ˨˩
hoài	h w aː j ˨˩
hoàn	h w aː n ˨˩
hoàng	h w aː ŋ ˨˩
hoá	h w aː ˧˦
hoãn	h w aː n ˦ˀ˥
hoè	h w ɛ ˨˩
hoạ	h w aː ˧˨ ʔ
hoạn	h w aː n ˧˨ ʔ
hoả	h w aː ˧˩
hoảng	h w aː ŋ ˧˩
hoắc	h w a k̚ ˧˦
hoẵng	h w a ŋ ˦ˀ˥
hoặc	h w a k̚ ˧˨ ʔ
hrê	h ɹ e ˧˧
hun	h u n ˧˧
hung	h ʊ w ŋ͡m ˧˧
huy	h w i ˧˧
huynh	h w ï ŋ̟ ˧˧
huyết	h w i ə t̚ ˧˦
huyền	h w i ə n ˨˩
huyện	h w i ə n ˧˨ ʔ
huyệt	h w i ə t̚ ˧˨ ʔ
huân	h w ə n ˧˧
huýt	h w i t̚ ˧˦
huơ	h w əː ˧˧
huế	h w e ˧˦
huề	h w e ˨˩
huệ	h w e ˧˨ ʔ
huống	h u ə ŋ ˧˦
huỳnh	h w ï ŋ̟ ˨˩
huỷ	h w i ˧˩
hyginô	h i ˧˧ z i ˧˧ n o ˧˧
hypebol	h i ˧˧ p ɛ ˧˧ ʔ ɓ ɔ n ˧˧
hà	h aː ˨˩
hài	h aː j ˨˩
hàm	h aː m ˨˩
hàn	h aː n ˨˩
hàng	h aː ŋ ˨˩
hành	h a j ŋ̟ ˨˩
hào	h a w ˨˩
hào	h aː w ˨˩
hàu	h a w ˨˩
há	h aː ˧˦
hái	h aː j ˧˦
hán	h aː n ˧˦
háng	h aː ŋ ˧˦
háo	h aː w ˧˦
hát	h aː t̚ ˧˦
hâm	h ə m ˧˧
hãi	h aː j ˦ˀ˥
hãm	h aː m ˦ˀ˥
hãn	h aː n ˦ˀ˥
hãng	h aː ŋ ˦ˀ˥
hãy	h a j ˦ˀ˥
hè	h ɛ ˨˩
hèm	h ɛ m ˨˩
hèn	h ɛ n ˨˩
hé	h ɛ ˧˦
héo	h ɛ w ˧˦
hét	h ɛ t̚ ˧˦
hên	h e n ˧˧
hình	h ï ŋ ˨˩
hí	h i ˧˦
hít	h i t̚ ˧˦
hò	h ɔ ˨˩
hòm	h ɔ m ˨˩
hòn	h ɔ n ˨˩
hòng	h a w ŋ͡m ˨˩
hóc	h a w k͡p̚ ˧˦
hói	h ɔ j ˧˦
hóng	h a w ŋ͡m ˧˦
hóp	h ɔ p̚ ˧˦
hót	h ɔ t̚ ˧˦
hô	h o ˧˧
hôi	h o j ˧˧
hôm	h o m ˧˧
hôn	h o n ˧˧
hông	h ə w ŋ͡m ˧˧
hù	h u ˨˩
hùa	h u ə ˨˩
hùm	h u m ˨˩
hùng	h ʊ w ŋ͡m ˨˩
hú	h u ˧˦
húc	h ʊ w k͡p̚ ˧˦
húp	h u p̚ ˧˦
hút	h u t̚ ˧˦
hăm	h a m ˧˧
hăng	h a ŋ ˧˧
hĩm	h i m ˦ˀ˥
hũ	h u ˦ˀ˥
hơ	h əː ˧˧
hơi	h əː j ˧˧
hơn	h əː n ˧˧
hư	h ɨ ˧˧
hưu	h i w ˧˧
hương	h ɨ ə ŋ ˧˧
hươu	h i ə w ˧˧
hướng	h ɨ ə ŋ ˧˦
hường	h ɨ ə ŋ ˨˩
hưởng	h ɨ ə ŋ ˧˩
hạ	h aː ˧˨ ʔ
hạc	h aː k̚ ˧˨ ʔ
hạch	h a j k̟̚ ˧˨ ʔ
hại	h aː j ˧˨ ʔ
hạm	h aː m ˧˨ ʔ
hạn	h aː n ˧˨ ʔ
hạng	h aː ŋ ˧˨ ʔ
hạnh	h a j ŋ̟ ˧˨ ʔ
hạo	h aː w ˧˨ ʔ
hạp	h aː p̚ ˧˨ ʔ
hạt	h aː t̚ ˧˨ ʔ
hả	h aː ˧˩
hải	h aː j ˧˩
hảo	h aː w ˧˩
hấp	h ə p̚ ˧˦
hất	h ə t̚ ˧˦
hầm	h ə m ˨˩
hầu	h ə w ˨˩
hẩy	h ə j ˧˩
hận	h ə n ˧˨ ʔ
hậu	h ə w ˧˨ ʔ
hắc	h a k̚ ˧˦
hắn	h a n ˧˦
hắt	h a t̚ ˧˦
hằng	h a ŋ ˨˩
hẳn	h a n ˧˩
hẵng	h a ŋ ˦ˀ˥
hẹ	h ɛ ˧˨ ʔ
hẹn	h ɛ n ˧˨ ʔ
hẹp	h ɛ p̚ ˧˨ ʔ
hẻm	h ɛ m ˧˩
hếch	h ə j k̟̚ ˧˦
hến	h e n ˧˦
hết	h e t̚ ˧˦
hề	h e ˨˩
hễ	h e ˦ˀ˥
hệch	h ə j k̟̚ ˧˨ ʔ
hệt	h e t̚ ˧˨ ʔ
hỉ	h i ˧˩
hịch	h ï k̟̚ ˧˨ ʔ
họ	h ɔ ˧˨ ʔ
học	h a w k͡p̚ ˧˨ ʔ
họng	h a w ŋ͡m ˧˨ ʔ
họp	h ɔ p̚ ˧˨ ʔ
hỏi	h ɔ j ˧˩
hỏng	h a w ŋ͡m ˧˩
hố	h o ˧˦
hốc	h ə w k͡p̚ ˧˦
hối	h o j ˧˦
hốt	h o t̚ ˧˦
hồ	h o ˨˩
hồi	h o j ˨˩
hồn	h o n ˨˩
hồng	h ə w ŋ͡m ˨˩
hổ	h o ˧˩
hổi	h o j ˧˩
hổm	h o m ˧˩
hổng	h ə w ŋ͡m ˧˩
hỗ	h o ˦ˀ˥
hỗn	h o n ˦ˀ˥
hộ	h o ˧˨ ʔ
hộc	h ə w k͡p̚ ˧˨ ʔ
hội	h o j ˧˨ ʔ
hộp	h o p̚ ˧˨ ʔ
hột	h o t̚ ˧˨ ʔ
hớn	h əː n ˧˦
hớp	h əː p̚ ˧˦
hớt	h əː t̚ ˧˦
hời	h əː j ˨˩
hờn	h əː n ˨˩
hở	h əː ˧˩
hỡi	h əː j ˦ˀ˥
hợi	h əː j ˧˨ ʔ
hợm	h əː m ˧˨ ʔ
hợp	h əː p̚ ˧˨ ʔ
hụ	h u ˧˨ ʔ
hụp	h u p̚ ˧˨ ʔ
hụt	h u t̚ ˧˨ ʔ
hủ	h u ˧˩
hứa	h ɨ ə ˧˦
hức	h ɨ k̚ ˧˦
hứng	h ɨ ŋ ˧˦
hử	h ɨ ˧˩
hửi	h ɨ j ˧˩
hửng	h ɨ ŋ ˧˩
hữu	h i w ˦ˀ˥
i	ʔ i ˧˧
im	ʔ i m ˧˧
in	ʔ i n ˧˧
inh	ʔ ï ŋ ˧˧
inhaxiô	ʔ i ˧˧ ɲ aː ˧˧ s i ˧˧ ʔ o ˧˧
inđi	ʔ i n ˧˧ ʔ ɗ i ˧˧
ion	ʔ i ˧˧ ʔ ə w ŋ͡m ˧˧
iot	ʔ i ˧˧ ʔ o t̚ ˧˦
iriđi	ʔ i ˧˧ ɹ i ˧˧ ʔ ɗ i ˧˧
isave	ʔ i ˧˧ s aː ˧˧ v ɛ ˧˧
iu	ʔ i w ˧˧
k	k aː ˧˧
kaki	k aː ˧˧ k i ˧˧
kali	k aː ˧˧ l i ˧˧
ke	k ɛ ˧˧
kem	k ɛ m ˧˧
ken	k ɛ n ˧˧
keng	k ɛ ŋ ˧˧
kenvin	k ɛ n ˧˧ v i n ˧˧
keo	k ɛ w ˧˧
khai	x aː j ˧˧
khan	x aː n ˧˧
khanh	x a j ŋ̟ ˧˧
khay	x a j ˧˧
khe	x ɛ ˧˧
khen	x ɛ n ˧˧
khi	x i ˧˧
khinh	x ï ŋ ˧˧
khiên	x i ə n ˧˧
khiêng	x i ə ŋ ˧˧
khiến	x i ə n ˧˦
khiếp	x i ə p̚ ˧˦
khiếu	x i ə w ˧˦
kho	x ɔ ˧˧
khoa	x w aː ˧˧
khoai	x w aː j ˧˧
khoan	x w aː n ˧˧
khoang	x w aː ŋ ˧˧
khoanh	x w a j ŋ̟ ˧˧
khoe	x w ɛ ˧˧
khoeo	x w ɛ w ˧˧
khom	x ɔ m ˧˧
khoá	x w aː ˧˦
khoác	x w aː k̚ ˧˦
khoái	x w aː j ˧˦
khoán	x w aː n ˧˦
khoáng	x w aː ŋ ˧˦
khoát	x w aː t̚ ˧˦
khoé	x w ɛ ˧˦
khoét	x w ɛ t̚ ˧˦
khoả	x w aː ˧˩
khoản	x w aː n ˧˩
khoảng	x w aː ŋ ˧˩
khoảnh	x w a j ŋ̟ ˧˩
khoằm	x w a m ˨˩
khoẻ	x w ɛ ˧˩
khu	x u ˧˧
khui	x u j ˧˧
khum	x u m ˧˧
khung	x ʊ w ŋ͡m ˧˧
khuy	x w i ˧˧
khuya	x w i ə ˧˧
khuyên	x w i ə n ˧˧
khuyến	x w i ə n ˧˦
khuyết	x w i ə t̚ ˧˦
khuân	x w ə n ˧˧
khuôn	x u ə n ˧˧
khuất	x w ə t̚ ˧˦
khuấy	x w ə j ˧˦
khuếch	x w ə j k̟̚ ˧˦
khuỷu	x w i w ˧˩
khàn	x aː n ˨˩
khá	x aː ˧˦
khác	x aː k̚ ˧˦
khách	x a j k̟̚ ˧˦
khái	x aː j ˧˦
khám	x aː m ˧˦
khán	x aː n ˧˦
kháng	x aː ŋ ˧˦
khánh	x a j ŋ̟ ˧˦
khát	x aː t̚ ˧˦
kháy	x a j ˧˦
khâu	x ə w ˧˧
khéo	x ɛ w ˧˦
khép	x ɛ p̚ ˧˦
khét	x ɛ t̚ ˧˦
khê	x e ˧˧
khêu	x e w ˧˧
khí	x i ˧˦
khía	x i ə ˧˦
khích	x ï k̟̚ ˧˦
khít	x i t̚ ˧˦
khó	x ɔ ˧˦
khóc	x a w k͡p̚ ˧˦
khói	x ɔ j ˧˦
khóm	x ɔ m ˧˦
khô	x o ˧˧
khôi	x o j ˧˧
khôn	x o n ˧˧
không	x ə w ŋ͡m ˧˧
khùng	x ʊ w ŋ͡m ˨˩
khúc	x ʊ w k͡p̚ ˧˦
khăm	x a m ˧˧
khăn	x a n ˧˧
khơi	x əː j ˧˧
khương	x ɨ ə ŋ ˧˧
khạc	x aː k̚ ˧˨ ʔ
khả	x aː ˧˩
khải	x aː j ˧˩
khảnh	x a j ŋ̟ ˧˩
khảo	x aː w ˧˩
khảy	x a j ˧˩
khấn	x ə n ˧˦
khấu	x ə w ˧˦
khẩu	x ə w ˧˩
khắc	x a k̚ ˧˦
khắm	x a m ˧˦
khắp	x a p̚ ˧˦
khẳn	x a n ˧˩
khẹc	x ɛ k̚ ˧˨ ʔ
khẽ	x ɛ ˦ˀ˥
khế	x e ˧˦
khều	x e w ˨˩
khểnh	x ə j ŋ̟ ˧˩
khỉ	x i ˧˩
khịt	x i t̚ ˧˨ ʔ
khỏ	x ɔ ˧˩
khỏi	x ɔ j ˧˩
khố	x o ˧˦
khối	x o j ˧˦
khổ	x o ˧˩
khổng	x ə w ŋ͡m ˧˩
khớp	x əː p̚ ˧˦
khờ	x əː ˨˩
khủng	x ʊ w ŋ͡m ˧˩
khứa	x ɨ ə ˧˦
khứng	x ɨ ŋ ˧˦
khử	x ɨ ˧˩
khựa	x ɨ ə ˧˨ ʔ
khựng	x ɨ ŋ ˧˨ ʔ
ki	k i ˧˧
kia	k i ə ˧˧
kilôgam	k i ˧˧ l o ˧˧ ɣ aː m ˧˧
kilômet	k i ˧˧ l o ˧˧ m ɛ t̚ ˧˦
kilômét	k i ˧˧ l o ˧˧ m ɛ t̚ ˧˦
kilôoat	k i ˧˧ l o ˧˧ ʔ w aː t̚ ˧˦
kim	k i m ˧˧
kinh	k ï ŋ ˧˧
kirixitô	k i ˧˧ z i ˧˧ s i ˧˧ t o ˧˧
kiêm	k i ə m ˧˧
kiên	k i ə n ˧˧
kiêng	k i ə ŋ ˧˧
kiêu	k i ə w ˧˧
kiếm	k i ə m ˧˦
kiến	k i ə n ˧˦
kiếng	k i ə ŋ ˧˦
kiếp	k i ə p̚ ˧˦
kiết	k i ə t̚ ˧˦
kiếu	k i ə w ˧˦
kiềm	k i ə m ˨˩
kiều	k i ə w ˨˩
kiểm	k i ə m ˧˩
kiểng	k i ə ŋ ˧˩
kiểu	k i ə w ˧˩
kiện	k i ə n ˧˨ ʔ
kiệt	k i ə t̚ ˧˨ ʔ
kiệu	k i ə w ˧˨ ʔ
koala	k o ˧˧ ʔ aː ˧˧ l aː ˧˧
kripton	k ɹ i p̚ ˧˦ t ə w ŋ͡m ˧˧
kute	k u ˧˧ t ɛ ˧˧
kè	k ɛ ˨˩
kèm	k ɛ m ˨˩
kèn	k ɛ n ˨˩
kèo	k ɛ w ˨˩
ké	k ɛ ˧˦
kém	k ɛ m ˧˦
kén	k ɛ n ˧˦
kéo	k ɛ w ˧˦
kép	k ɛ p̚ ˧˦
két	k ɛ t̚ ˧˦
kê	k e ˧˧
kênh	k ə j ŋ̟ ˧˧
kêu	k e w ˧˧
kì	k i ˨˩
kìa	k i ə ˨˩
kìm	k i m ˨˩
kình	k ï ŋ ˨˩
kí	k i ˧˦
kích	k ï k̟̚ ˧˦
kín	k i n ˧˦
kính	k ï ŋ ˧˦
kíp	k i p̚ ˧˦
kĩ	k i ˦ˀ˥
kẹc	k ɛ k̚ ˧˨ ʔ
kẹo	k ɛ w ˧˨ ʔ
kẹp	k ɛ p̚ ˧˨ ʔ
kẹt	k ɛ t̚ ˧˨ ʔ
kẻ	k ɛ ˧˩
kẻng	k ɛ ŋ ˧˩
kẻo	k ɛ w ˧˩
kẽ	k ɛ ˦ˀ˥
kẽm	k ɛ m ˦ˀ˥
kế	k e ˧˦
kếch	k ə j k̟̚ ˧˦
kết	k e t̚ ˧˦
kề	k e ˨˩
kền	k e n ˨˩
kềnh	k ə j ŋ̟ ˨˩
kể	k e ˧˩
kệ	k e ˧˨ ʔ
kệch	k ə j k̟̚ ˧˨ ʔ
kỉ	k i ˧˩
kịch	k ï k̟̚ ˧˨ ʔ
kịp	k i p̚ ˧˨ ʔ
l	ʔ ɛ ˧˧ l əː ˨˩
la	l aː ˧˧
lai	l aː j ˧˧
lam	l aː m ˧˧
lan	l aː n ˧˧
lang	l aː ŋ ˧˧
lanh	l a j ŋ̟ ˧˧
lantan	l aː n ˧˧ t aː n ˧˧
lao	l aː w ˧˧
latinh	l aː ˧˧ t ï ŋ ˧˧
lau	l a w ˧˧
lay	l a j ˧˧
le	l ɛ ˧˧
lem	l ɛ m ˧˧
len	l ɛ n ˧˧
leo	l ɛ w ˧˧
li	l i ˧˧
lia	l i ə ˧˧
lim	l i m ˧˧
linh	l ï ŋ ˧˧
linô	l i n ˧˧ n o ˧˧
liti	l i ˧˧ t i ˧˧
livermori	l i ˧˧ v əː ˧˧ m ɔ ˧˧ ɹ i ˧˧
liêm	l i ə m ˧˧
liên	l i ə n ˧˧
liếc	l i ə k̚ ˧˦
liếm	l i ə m ˧˦
liềm	l i ə m ˨˩
liền	l i ə n ˨˩
liều	l i ə w ˨˩
liễu	l i ə w ˦ˀ˥
liệng	l i ə ŋ ˧˨ ʔ
liệt	l i ə t̚ ˧˨ ʔ
liệu	l i ə w ˧˨ ʔ
lo	l ɔ ˧˧
loa	l w aː ˧˧
loan	l w aː n ˧˧
loang	l w aː ŋ ˧˧
lon	l ɔ n ˧˧
long	l a w ŋ͡m ˧˧
lorenxi	l ɔ ˧˧ ɹ ɛ n ˧˧ s i ˧˧
loài	l w aː j ˨˩
loá	l w aː ˧˦
loán	l w aː n ˧˦
loãng	l w aː ŋ ˦ˀ˥
loè	l w ɛ ˨˩
loé	l w ɛ ˧˦
loét	l w ɛ t̚ ˧˦
loại	l w aː j ˧˨ ʔ
loạn	l w aː n ˧˨ ʔ
loạt	l w aː t̚ ˧˨ ʔ
lu	l u ˧˧
luca	l u ˧˧ k aː ˧˧
luciô	l u ˧˧ s i ˧˧ ʔ o ˧˧
lui	l u j ˧˧
lung	l ʊ w ŋ͡m ˧˧
lutexi	l u ˧˧ t e ˧˧ s i ˧˧
luyến	l w i ə n ˧˦
luyện	l w i ə n ˧˨ ʔ
luân	l w ə n ˧˧
luôn	l u ə n ˧˧
luận	l w ə n ˧˨ ʔ
luật	l w ə t̚ ˧˨ ʔ
luốc	l u ə k̚ ˧˦
luống	l u ə ŋ ˧˦
luồn	l u ə n ˨˩
luồng	l u ə ŋ ˨˩
luộc	l u ə k̚ ˧˨ ʔ
luỹ	l w i ˦ˀ˥
là	l aː ˨˩
lài	l aː j ˨˩
làm	l aː m ˨˩
làn	l aː n ˨˩
làng	l aː ŋ ˨˩
lành	l a j ŋ̟ ˨˩
lào	l aː w ˨˩
lá	l aː ˧˦
lác	l aː k̚ ˧˦
lách	l a j k̟̚ ˧˦
lái	l aː j ˧˦
lán	l aː n ˧˦
láng	l aː ŋ ˧˦
lánh	l a j ŋ̟ ˧˦
láo	l aː w ˧˦
lát	l aː t̚ ˧˦
láy	l a j ˧˦
lâm	l ə m ˧˧
lân	l ə n ˧˧
lâu	l ə w ˧˧
lây	l ə j ˧˧
lãi	l aː j ˦ˀ˥
lãng	l aː ŋ ˦ˀ˥
lãnh	l a j ŋ̟ ˦ˀ˥
lão	l aː w ˦ˀ˥
lè	l ɛ ˨˩
lé	l ɛ ˧˦
lén	l ɛ n ˧˦
lép	l ɛ p̚ ˧˦
lê	l e ˧˧
lên	l e n ˧˧
lêô	l e ˧˧ ʔ o ˧˧
lì	l i ˨˩
lìa	l i ə ˨˩
lìn	l i n ˨˩
lí	l i ˧˦
lính	l ï ŋ ˧˦
líp	l i p̚ ˧˦
lít	l i t̚ ˧˦
lò	l ɔ ˨˩
lòi	l ɔ j ˨˩
lòn	l ɔ n ˨˩
lòng	l a w ŋ͡m ˨˩
ló	l ɔ ˧˦
lóc	l a w k͡p̚ ˧˦
lóng	l a w ŋ͡m ˧˦
lót	l ɔ t̚ ˧˦
lôgarit	l o ˧˧ ɣ aː ˧˧ ɹ i t̚ ˧˧
lôgic	l o ˧˧ z ï k̟̚ ˧˦
lôi	l o j ˧˧
lông	l ə w ŋ͡m ˧˧
lôrensô	l o ˧˧ z ɛ n ˧˧ s o ˧˧
lõ	l ɔ ˦ˀ˥
lõi	l ɔ j ˦ˀ˥
lõm	l ɔ m ˦ˀ˥
lõng	l a w ŋ͡m ˦ˀ˥
lùa	l u ə ˨˩
lùi	l u j ˨˩
lùm	l u m ˨˩
lùn	l u n ˨˩
lùng	l ʊ w ŋ͡m ˨˩
lú	l u ˧˦
lúa	l u ə ˧˦
lúc	l ʊ w k͡p̚ ˧˦
lún	l u n ˧˦
lăm	l a m ˧˧
lăn	l a n ˧˧
lăng	l a ŋ ˧˧
lĩnh	l ï ŋ ˦ˀ˥
lũ	l u ˦ˀ˥
lơ	l əː ˧˧
lơi	l əː j ˧˧
lưng	l ɨ ŋ ˧˧
lưu	l i w ˧˧
lươn	l ɨ ə n ˧˧
lương	l ɨ ə ŋ ˧˧
lưới	l ɨ ə j ˧˦
lướt	l ɨ ə t̚ ˧˦
lười	l ɨ ə j ˨˩
lườm	l ɨ ə m ˨˩
lườn	l ɨ ə n ˨˩
lường	l ɨ ə ŋ ˨˩
lưỡi	l ɨ ə j ˦ˀ˥
lược	l ɨ ə k̚ ˧˨ ʔ
lượm	l ɨ ə m ˧˨ ʔ
lượn	l ɨ ə n ˧˨ ʔ
lượng	l ɨ ə ŋ ˧˨ ʔ
lượt	l ɨ ə t̚ ˧˨ ʔ
lạ	l aː ˧˨ ʔ
lạc	l aː k̚ ˧˨ ʔ
lạch	l a j k̟̚ ˧˨ ʔ
lại	l aː j ˧˨ ʔ
lạng	l aː ŋ ˧˨ ʔ
lạnh	l a j ŋ̟ ˧˨ ʔ
lạt	l aː t̚ ˧˨ ʔ
lạy	l a j ˧˨ ʔ
lảng	l aː ŋ ˧˩
lấm	l ə m ˧˦
lấn	l ə n ˧˦
lấp	l ə p̚ ˧˦
lấy	l ə j ˧˦
lầm	l ə m ˨˩
lần	l ə n ˨˩
lầu	l ə w ˨˩
lầy	l ə j ˨˩
lẩn	l ə n ˧˩
lẩu	l ə w ˧˩
lẫn	l ə n ˦ˀ˥
lẫy	l ə j ˦ˀ˥
lận	l ə n ˧˨ ʔ
lập	l ə p̚ ˧˨ ʔ
lật	l ə t̚ ˧˨ ʔ
lậu	l ə w ˧˨ ʔ
lắc	l a k̚ ˧˦
lắm	l a m ˧˦
lắng	l a ŋ ˧˦
lắp	l a p̚ ˧˦
lằn	l a n ˨˩
lẵng	l a ŋ ˦ˀ˥
lặn	l a n ˧˨ ʔ
lặng	l a ŋ ˧˨ ʔ
lặp	l a p̚ ˧˨ ʔ
lặt	l a t̚ ˧˨ ʔ
lẹ	l ɛ ˧˨ ʔ
lẹo	l ɛ w ˧˨ ʔ
lẻ	l ɛ ˧˩
lẻn	l ɛ n ˧˩
lẽ	l ɛ ˦ˀ˥
lết	l e t̚ ˧˦
lề	l e ˨˩
lều	l e w ˨˩
lễ	l e ˦ˀ˥
lệ	l e ˧˨ ʔ
lệch	l ə j k̟̚ ˧˨ ʔ
lệnh	l ə j ŋ̟ ˧˨ ʔ
lị	l i ˧˨ ʔ
lịch	l ï k̟̚ ˧˨ ʔ
lịm	l i m ˧˨ ʔ
lọ	l ɔ ˧˨ ʔ
lọc	l a w k͡p̚ ˧˨ ʔ
lọn	l ɔ n ˧˨ ʔ
lọt	l ɔ t̚ ˧˨ ʔ
lỏm	l ɔ m ˧˩
lỏng	l a w ŋ͡m ˧˩
lố	l o ˧˦
lốc	l ə w k͡p̚ ˧˦
lối	l o j ˧˦
lốp	l o p̚ ˧˦
lốt	l o t̚ ˧˦
lồi	l o j ˨˩
lồn	l o n ˨˩
lồng	l ə w ŋ͡m ˨˩
lỗ	l o ˦ˀ˥
lỗi	l o j ˦ˀ˥
lộ	l o ˧˨ ʔ
lộc	l ə w k͡p̚ ˧˨ ʔ
lội	l o j ˧˨ ʔ
lộn	l o n ˧˨ ʔ
lộng	l ə w ŋ͡m ˧˨ ʔ
lột	l o t̚ ˧˨ ʔ
lớn	l əː n ˧˦
lớp	l əː p̚ ˧˦
lờ	l əː ˨˩
lời	l əː j ˨˩
lờn	l əː n ˨˩
lở	l əː ˧˩
lỡ	l əː ˦ˀ˥
lợi	l əː j ˧˨ ʔ
lợn	l əː n ˧˨ ʔ
lợp	l əː p̚ ˧˨ ʔ
lụa	l u ə ˧˨ ʔ
lục	l ʊ w k͡p̚ ˧˨ ʔ
lụm	l u m ˧˨ ʔ
lụt	l u t̚ ˧˨ ʔ
lủng	l ʊ w ŋ͡m ˧˩
lứa	l ɨ ə ˧˦
lừa	l ɨ ə ˨˩
lừng	l ɨ ŋ ˨˩
lửa	l ɨ ə ˧˩
lửng	l ɨ ŋ ˧˩
lự	l ɨ ˧˨ ʔ
lựa	l ɨ ə ˧˨ ʔ
lực	l ɨ k̚ ˧˨ ʔ
lựu	l i w ˧˨ ʔ
m	ʔ ɛ ˧˧ m əː ˨˩
m'nông	m əː ˧˧ n ə w ŋ͡m ˧˧
ma	m aː ˧˧
magie	m aː ˧˧ z e ˧˧
mai	m aː j ˧˧
man	m aː n ˧˧
mang	m aː ŋ ˧˧
mangan	m aː n ˧˧ ɣ aː n ˧˧
manh	m a j ŋ̟ ˧˧
maria	m aː ˧˧ z i ˧˧ ʔ aː ˧˧
maroc	m aː ˧˧ ɹ ə w k͡p̚ ˧˦
martinô	m aː ˧˧ t i n ˧˧ n o ˧˧
mau	m a w ˧˧
may	m a j ˧˧
mc	ʔ ɛ m ˧˧ s i ˧˧
me	m ɛ ˧˧
men	m ɛ n ˧˧
menđelevi	m ɛ n ˧˧ ʔ ɗ e ˧˧ l e ˧˧ v i ˧˧
meo	m ɛ w ˧˧
mi	m i ˧˧
micae	m i ˧˧ k aː ˧˧ ʔ ɛ ˧˧
min	m i n ˧˧
minh	m ï ŋ ˧˧
miu	m i w ˧˧
miên	m i ə n ˧˧
miến	m i ə n ˧˦
miếng	m i ə ŋ ˧˦
miếu	m i ə w ˧˦
miền	m i ə n ˨˩
miểng	m i ə ŋ ˧˩
miễn	m i ə n ˦ˀ˥
miệng	m i ə ŋ ˧˨ ʔ
mo	m ɔ ˧˧
moa	m w aː ˧˧
modem	m o ˧˧ ʔ ɗ e m ˧˧
moi	m ɔ j ˧˧
mol	m ɔ n ˧˧
molipđen	m o ˧˧ l i p̚ ˧˦ ʔ ɗ ɛ n ˧˧
mong	m a w ŋ͡m ˧˧
moóc	m ɔ k̚ ˧˦
moạ	m w aː ˧˨ ʔ
moả	m w aː ˧˩
mtdtgpmnvn	m a t̚ ˧˨ ʔ t͡ɕ ə n ˧˨ ʔ z ə n ˧˧ t ə w k͡p̚ ˧˨ ʔ z aː j ˧˩ f a w ŋ͡m ˧˦ m i ə n ˨˩ n aː m ˧˧ v i ə t̚ ˧˨ ʔ n aː m ˧˧
mu	m u ˧˧
mua	m u ə ˧˧
mui	m u j ˧˧
mun	m u n ˧˧
muôi	m u ə j ˧˧
muôn	m u ə n ˧˧
muông	m u ə ŋ ˧˧
muối	m u ə j ˧˦
muốn	m u ə n ˧˦
muống	m u ə ŋ ˧˦
muỗi	m u ə j ˦ˀ˥
muỗng	m u ə ŋ ˦ˀ˥
muội	m u ə j ˧˨ ʔ
muộn	m u ə n ˧˨ ʔ
mà	m aː ˨˩
mài	m aː j ˨˩
màn	m aː n ˨˩
màng	m aː ŋ ˨˩
mào	m aː w ˨˩
màu	m a w ˨˩
mày	m a j ˨˩
má	m aː ˧˦
mác	m aː k̚ ˧˦
máccô	m aː k̚ ˧˦ k o ˧˧
mách	m a j k̟̚ ˧˦
máctinô	m aː k̚ ˧˦ t i ˧˧ n o ˧˧
mái	m aː j ˧˦
máng	m aː ŋ ˧˦
mánh	m a j ŋ̟ ˧˦
mát	m aː t̚ ˧˦
mátthêu	m aː t̚ ˧˦ tʰ e w ˧˧
máu	m a w ˧˦
máy	m a j ˧˦
mâm	m ə m ˧˧
mân	m ə n ˧˧
mây	m ə j ˧˧
mã	m aː ˦ˀ˥
mãi	m aː j ˦ˀ˥
mãn	m aː n ˦ˀ˥
mão	m aː w ˦ˀ˥
mè	m ɛ ˨˩
mèm	m ɛ m ˨˩
mèo	m ɛ w ˨˩
mé	m ɛ ˧˦
méc	m ɛ k̚ ˧˦
mén	m ɛ n ˧˦
méo	m ɛ w ˧˦
mép	m ɛ p̚ ˧˦
mét	m ɛ t̚ ˧˦
mê	m e ˧˧
mì	m i ˨˩
mìn	m i n ˨˩
mình	m ï ŋ ˨˩
mí	m i ˧˦
mía	m i ə ˧˦
mím	m i m ˧˦
mít	m i t̚ ˧˦
mò	m ɔ ˨˩
mòn	m ɔ n ˨˩
mòng	m a w ŋ͡m ˨˩
mó	m ɔ ˧˦
móc	m a w k͡p̚ ˧˦
móm	m ɔ m ˧˦
món	m ɔ n ˧˦
móng	m a w ŋ͡m ˧˦
móp	m ɔ p̚ ˧˦
mót	m ɔ t̚ ˧˦
mô	m o ˧˧
môi	m o j ˧˧
môn	m o n ˧˧
mông	m ə w ŋ͡m ˧˧
mônica	m o n ˧˧ n i ˧˧ k aː ˧˧
mõ	m ɔ ˦ˀ˥
mõm	m ɔ m ˦ˀ˥
mù	m u ˨˩
mùa	m u ə ˨˩
mùi	m u j ˨˩
mùn	m u n ˨˩
mùng	m ʊ w ŋ͡m ˨˩
múa	m u ə ˧˦
múc	m ʊ w k͡p̚ ˧˦
múi	m u j ˧˦
múp	m u p̚ ˧˦
mút	m u t̚ ˧˦
măm	m a m ˧˧
măng	m a ŋ ˧˧
mĩ	m i ˦ˀ˥
mũ	m u ˦ˀ˥
mũi	m u j ˦ˀ˥
mơ	m əː ˧˧
mưa	m ɨ ə ˧˧
mưu	m i w ˧˧
mươi	m ɨ ə j ˧˧
mương	m ɨ ə ŋ ˧˧
mướn	m ɨ ə n ˧˦
mướp	m ɨ ə p̚ ˧˦
mướt	m ɨ ə t̚ ˧˦
mười	m ɨ ə j ˨˩
mường	m ɨ ə ŋ ˨˩
mượn	m ɨ ə n ˧˨ ʔ
mượt	m ɨ ə t̚ ˧˨ ʔ
mạ	m aː ˧˨ ʔ
mạc	m aː k̚ ˧˨ ʔ
mạch	m a j k̟̚ ˧˨ ʔ
mạn	m aː n ˧˨ ʔ
mạng	m aː ŋ ˧˨ ʔ
mạnh	m a j ŋ̟ ˧˨ ʔ
mạo	m aː w ˧˨ ʔ
mạt	m aː t̚ ˧˨ ʔ
mả	m aː ˧˩
mải	m aː j ˧˩
mảng	m aː ŋ ˧˩
mảnh	m a j ŋ̟ ˧˩
mấn	m ə n ˧˦
mất	m ə t̚ ˧˦
mấu	m ə w ˧˦
mấy	m ə j ˧˦
mầm	m ə m ˨˩
mần	m ə n ˨˩
mầu	m ə w ˨˩
mầy	m ə j ˨˩
mẩu	m ə w ˧˩
mẩy	m ə j ˧˩
mẫn	m ə n ˦ˀ˥
mẫu	m ə w ˦ˀ˥
mận	m ə n ˧˨ ʔ
mập	m ə p̚ ˧˨ ʔ
mật	m ə t̚ ˧˨ ʔ
mậu	m ə w ˧˨ ʔ
mắc	m a k̚ ˧˦
mắm	m a m ˧˦
mắn	m a n ˧˦
mắng	m a ŋ ˧˦
mắt	m a t̚ ˧˦
mặc	m a k̚ ˧˨ ʔ
mặn	m a n ˧˨ ʔ
mặt	m a t̚ ˧˨ ʔ
mẹ	m ɛ ˧˨ ʔ
mẹo	m ɛ w ˧˨ ʔ
mẻ	m ɛ ˧˩
mẽ	m ɛ ˦ˀ˥
mến	m e n ˧˦
mếu	m e w ˧˦
mề	m e ˨˩
mềm	m e m ˨˩
mền	m e n ˨˩
mễ	m e ˦ˀ˥
mệ	m e ˧˨ ʔ
mệnh	m ə j ŋ̟ ˧˨ ʔ
mệt	m e t̚ ˧˨ ʔ
mỉa	m i ə ˧˩
mỉm	m i m ˧˩
mịn	m i n ˧˨ ʔ
mịt	m i t̚ ˧˨ ʔ
mọc	m a w k͡p̚ ˧˨ ʔ
mọi	m ɔ j ˧˨ ʔ
mọn	m ɔ n ˧˨ ʔ
mọng	m a w ŋ͡m ˧˨ ʔ
mọt	m ɔ t̚ ˧˨ ʔ
mỏ	m ɔ ˧˩
mỏi	m ɔ j ˧˩
mỏng	m a w ŋ͡m ˧˩
mốc	m ə w k͡p̚ ˧˦
mối	m o j ˧˦
mống	m ə w ŋ͡m ˧˦
mốt	m o t̚ ˧˦
mồ	m o ˨˩
mồi	m o j ˨˩
mồm	m o m ˨˩
mồng	m ə w ŋ͡m ˨˩
mổ	m o ˧˩
mỗi	m o j ˦ˀ˥
mộ	m o ˧˨ ʔ
mộc	m ə w k͡p̚ ˧˨ ʔ
mộng	m ə w ŋ͡m ˧˨ ʔ
một	m o t̚ ˧˨ ʔ
mớ	m əː ˧˦
mới	m əː j ˧˦
mớm	m əː m ˧˦
mờ	m əː ˨˩
mời	m əː j ˨˩
mở	m əː ˧˩
mỡ	m əː ˦ˀ˥
mợ	m əː ˧˨ ʔ
mụ	m u ˧˨ ʔ
mục	m ʊ w k͡p̚ ˧˨ ʔ
mụn	m u n ˧˨ ʔ
mụp	m u p̚ ˧˨ ʔ
mụt	m u t̚ ˧˨ ʔ
mủ	m u ˧˩
mủi	m u j ˧˩
mủn	m u n ˧˩
mứa	m ɨ ə ˧˦
mức	m ɨ k̚ ˧˦
mứt	m ɨ t̚ ˧˦
mừng	m ɨ ŋ ˨˩
mửa	m ɨ ə ˧˩
mực	m ɨ k̚ ˧˨ ʔ
n	ʔ ɛ ˧˧ n əː ˨˩
na	n aː ˧˧
nai	n aː j ˧˧
nam	n aː m ˧˧
nan	n aː n ˧˧
nang	n aː ŋ ˧˧
nanh	n a j ŋ̟ ˧˧
nao	n aː w ˧˧
napan	n aː ˧˧ p aː n ˧˧
natri	n aː ˧˧ t͡ɕ i ˧˧
nay	n a j ˧˧
nem	n ɛ m ˧˧
neo	n ɛ w ˧˧
neon	n e ˧˧ ʔ ə w ŋ͡m ˧˧
neođim	n e ˧˧ ʔ o ˧˧ ʔ ɗ i m ˧˧
nga	ŋ aː ˧˧
ngai	ŋ aː j ˧˧
ngan	ŋ aː n ˧˧
ngang	ŋ aː ŋ ˧˧
ngao	ŋ aː w ˧˧
ngay	ŋ a j ˧˧
nghe	ŋ ɛ ˧˧
nghen	ŋ ɛ n ˧˧
nghi	ŋ i ˧˧
nghiêm	ŋ i ə m ˧˧
nghiên	ŋ i ə n ˧˧
nghiêng	ŋ i ə ŋ ˧˧
nghiến	ŋ i ə n ˧˦
nghiền	ŋ i ə n ˨˩
nghiệm	ŋ i ə m ˧˨ ʔ
nghiện	ŋ i ə n ˧˨ ʔ
nghiệp	ŋ i ə p̚ ˧˨ ʔ
nghiệt	ŋ i ə t̚ ˧˨ ʔ
nghèo	ŋ ɛ w ˨˩
nghé	ŋ ɛ ˧˦
nghén	ŋ ɛ n ˧˦
nghê	ŋ e ˧˧
nghênh	ŋ ə j ŋ̟ ˧˧
nghêu	ŋ e w ˧˧
nghìm	ŋ i m ˨˩
nghìn	ŋ i n ˨˩
nghía	ŋ i ə ˧˦
nghĩ	ŋ i ˦ˀ˥
nghĩa	ŋ i ə ˦ˀ˥
nghẹ	ŋ ɛ ˧˨ ʔ
nghẹn	ŋ ɛ n ˧˨ ʔ
nghẹo	ŋ ɛ w ˧˨ ʔ
nghẹt	ŋ ɛ t̚ ˧˨ ʔ
nghẽn	ŋ ɛ n ˦ˀ˥
nghếch	ŋ ə j k̟̚ ˧˦
nghề	ŋ e ˨˩
nghệ	ŋ e ˧˨ ʔ
nghỉ	ŋ i ˧˩
nghị	ŋ i ˧˨ ʔ
nghịch	ŋ ï k̟̚ ˧˨ ʔ
nghịt	ŋ i t̚ ˧˨ ʔ
ngoa	ŋ w aː ˧˧
ngoan	ŋ w aː n ˧˧
ngoi	ŋ ɔ j ˧˧
ngon	ŋ ɔ n ˧˧
ngoài	ŋ w aː j ˨˩
ngoái	ŋ w aː j ˧˦
ngoáy	ŋ w a j ˧˦
ngoé	ŋ w ɛ ˧˦
ngoém	ŋ w ɛ m ˧˦
ngoại	ŋ w aː j ˧˨ ʔ
ngoạm	ŋ w aː m ˧˨ ʔ
ngoải	ŋ w aː j ˧˩
ngoảnh	ŋ w a j ŋ̟ ˧˩
ngoảy	ŋ w a j ˧˩
ngoắc	ŋ w a k̚ ˧˦
ngoắt	ŋ w a t̚ ˧˦
ngoặc	ŋ w a k̚ ˧˨ ʔ
ngoặt	ŋ w a t̚ ˧˨ ʔ
ngoẹo	ŋ w ɛ w ˧˨ ʔ
ngu	ŋ u ˧˧
nguy	ŋ w i ˧˧
nguyên	ŋ w i ə n ˧˧
nguyền	ŋ w i ə n ˨˩
nguyễn	ŋ w i ə n ˦ˀ˥
nguyện	ŋ w i ə n ˧˨ ʔ
nguyệt	ŋ w i ə t̚ ˧˨ ʔ
nguôi	ŋ u ə j ˧˧
nguồn	ŋ u ə n ˨˩
nguội	ŋ u ə j ˧˨ ʔ
nguỵ	ŋ w i ˧˨ ʔ
ngà	ŋ aː ˨˩
ngài	ŋ aː j ˨˩
ngàn	ŋ aː n ˨˩
ngành	ŋ a j ŋ̟ ˨˩
ngày	ŋ a j ˨˩
ngách	ŋ a j k̟̚ ˧˦
ngái	ŋ aː j ˧˦
ngám	ŋ aː m ˧˦
ngán	ŋ aː n ˧˦
ngáo	ŋ aː w ˧˦
ngáp	ŋ aː p̚ ˧˦
ngát	ŋ aː t̚ ˧˦
ngáy	ŋ a j ˧˦
ngâm	ŋ ə m ˧˧
ngân	ŋ ə n ˧˧
ngâu	ŋ ə w ˧˧
ngây	ŋ ə j ˧˧
ngã	ŋ aː ˦ˀ˥
ngãi	ŋ aː j ˦ˀ˥
ngò	ŋ ɔ ˨˩
ngòi	ŋ ɔ j ˨˩
ngó	ŋ ɔ ˧˦
ngóc	ŋ a w k͡p̚ ˧˦
ngói	ŋ ɔ j ˧˦
ngón	ŋ ɔ n ˧˦
ngóng	ŋ a w ŋ͡m ˧˦
ngót	ŋ ɔ t̚ ˧˦
ngô	ŋ o ˧˧
ngôi	ŋ o j ˧˧
ngôn	ŋ o n ˧˧
ngông	ŋ ə w ŋ͡m ˧˧
ngõ	ŋ ɔ ˦ˀ˥
ngõi	ŋ ɔ j ˦ˀ˥
ngù	ŋ u ˨˩
ngùi	ŋ u j ˨˩
ngăm	ŋ a m ˧˧
ngăn	ŋ a n ˧˧
ngũ	ŋ u ˦ˀ˥
ngơi	ŋ əː j ˧˧
ngư	ŋ ɨ ˧˧
ngưng	ŋ ɨ ŋ ˧˧
ngươi	ŋ ɨ ə j ˧˧
ngước	ŋ ɨ ə k̚ ˧˦
người	ŋ ɨ ə j ˨˩
ngưỡng	ŋ ɨ ə ŋ ˦ˀ˥
ngược	ŋ ɨ ə k̚ ˧˨ ʔ
ngượng	ŋ ɨ ə ŋ ˧˨ ʔ
ngại	ŋ aː j ˧˨ ʔ
ngạo	ŋ aː w ˧˨ ʔ
ngạt	ŋ aː t̚ ˧˨ ʔ
ngả	ŋ aː ˧˩
ngấm	ŋ ə m ˧˦
ngấn	ŋ ə n ˧˦
ngất	ŋ ə t̚ ˧˦
ngấy	ŋ ə j ˧˦
ngầm	ŋ ə m ˨˩
ngần	ŋ ə n ˨˩
ngầu	ŋ ə w ˨˩
ngẩn	ŋ ə n ˧˩
ngẩng	ŋ ə ŋ ˧˩
ngẫm	ŋ ə m ˦ˀ˥
ngậm	ŋ ə m ˧˨ ʔ
ngập	ŋ ə p̚ ˧˨ ʔ
ngậy	ŋ ə j ˧˨ ʔ
ngắm	ŋ a m ˧˦
ngắn	ŋ a n ˧˦
ngắt	ŋ a t̚ ˧˦
ngặt	ŋ a t̚ ˧˨ ʔ
ngọ	ŋ ɔ ˧˨ ʔ
ngọc	ŋ a w k͡p̚ ˧˨ ʔ
ngọn	ŋ ɔ n ˧˨ ʔ
ngọng	ŋ a w ŋ͡m ˧˨ ʔ
ngọt	ŋ ɔ t̚ ˧˨ ʔ
ngỏ	ŋ ɔ ˧˩
ngố	ŋ o ˧˦
ngốc	ŋ ə w k͡p̚ ˧˦
ngốn	ŋ o n ˧˦
ngồi	ŋ o j ˨˩
ngỗng	ŋ ə w ŋ͡m ˦ˀ˥
ngộ	ŋ o ˧˨ ʔ
ngộp	ŋ o p̚ ˧˨ ʔ
ngột	ŋ o t̚ ˧˨ ʔ
ngớ	ŋ əː ˧˦
ngớp	ŋ əː p̚ ˧˦
ngớt	ŋ əː t̚ ˧˦
ngờ	ŋ əː ˨˩
ngời	ŋ əː j ˨˩
ngỡ	ŋ əː ˦ˀ˥
ngợi	ŋ əː j ˧˨ ʔ
ngợm	ŋ əː m ˧˨ ʔ
ngợp	ŋ əː p̚ ˧˨ ʔ
ngụ	ŋ u ˧˨ ʔ
ngục	ŋ ʊ w k͡p̚ ˧˨ ʔ
ngụm	ŋ u m ˧˨ ʔ
ngụp	ŋ u p̚ ˧˨ ʔ
ngủ	ŋ u ˧˩
ngủm	ŋ u m ˧˩
ngứa	ŋ ɨ ə ˧˦
ngừa	ŋ ɨ ə ˨˩
ngừng	ŋ ɨ ŋ ˨˩
ngửa	ŋ ɨ ə ˧˩
ngửi	ŋ ɨ j ˧˩
ngữ	ŋ ɨ ˦ˀ˥
ngự	ŋ ɨ ˧˨ ʔ
ngựa	ŋ ɨ ə ˧˨ ʔ
ngực	ŋ ɨ k̚ ˧˨ ʔ
nha	ɲ aː ˧˧
nhai	ɲ aː j ˧˧
nhang	ɲ aː ŋ ˧˧
nhanh	ɲ a j ŋ̟ ˧˧
nhau	ɲ a w ˧˧
nhe	ɲ ɛ ˧˧
nheo	ɲ ɛ w ˧˧
nhi	ɲ i ˧˧
nhiêu	ɲ i ə w ˧˧
nhiếc	ɲ i ə k̚ ˧˦
nhiều	ɲ i ə w ˨˩
nhiễm	ɲ i ə m ˦ˀ˥
nhiễu	ɲ i ə w ˦ˀ˥
nhiệt	ɲ i ə t̚ ˧˨ ʔ
nho	ɲ ɔ ˧˧
nhoi	ɲ ɔ j ˧˧
nhoà	ɲ w aː ˨˩
nhoáng	ɲ w aː ŋ ˧˦
nhoẻn	ɲ w ɛ n ˧˩
nhu	ɲ u ˧˧
nhung	ɲ ʊ w ŋ͡m ˧˧
nhuyễn	ɲ w i ə n ˦ˀ˥
nhuốm	ɲ u ə m ˧˦
nhuộm	ɲ u ə m ˧˨ ʔ
nhuỵ	ɲ w i ˧˨ ʔ
nhà	ɲ aː ˨˩
nhài	ɲ aː j ˨˩
nhàm	ɲ aː m ˨˩
nhàn	ɲ aː n ˨˩
nhào	ɲ aː w ˨˩
nhàu	ɲ a w ˨˩
nhá	ɲ aː ˧˦
nhác	ɲ aː k̚ ˧˦
nhách	ɲ a j k̟̚ ˧˦
nhái	ɲ aː j ˧˦
nhám	ɲ aː m ˧˦
nhánh	ɲ a j ŋ̟ ˧˦
nháo	ɲ aː w ˧˦
nháp	ɲ aː p̚ ˧˦
nhát	ɲ aː t̚ ˧˦
nháy	ɲ a j ˧˦
nhâm	ɲ ə m ˧˧
nhân	ɲ ə n ˧˧
nhây	ɲ ə j ˧˧
nhã	ɲ aː ˦ˀ˥
nhãn	ɲ aː n ˦ˀ˥
nhãng	ɲ aː ŋ ˦ˀ˥
nhão	ɲ aː w ˦ˀ˥
nhè	ɲ ɛ ˨˩
nhé	ɲ ɛ ˧˦
nhéo	ɲ ɛ w ˧˦
nhép	ɲ ɛ p̚ ˧˦
nhét	ɲ ɛ t̚ ˧˦
nhì	ɲ i ˨˩
nhìn	ɲ i n ˨˩
nhí	ɲ i ˧˦
nhích	ɲ ï k̟̚ ˧˦
nhím	ɲ i m ˧˦
nhíp	ɲ i p̚ ˧˦
nhíu	ɲ i w ˧˦
nhòm	ɲ ɔ m ˨˩
nhóc	ɲ a w k͡p̚ ˧˦
nhói	ɲ ɔ j ˧˦
nhóm	ɲ ɔ m ˧˦
nhón	ɲ ɔ n ˧˦
nhót	ɲ ɔ t̚ ˧˦
nhô	ɲ o ˧˧
nhôm	ɲ o m ˧˧
nhông	ɲ ə w ŋ͡m ˧˧
nhôông	ɲ o ŋ ˧˧
nhú	ɲ u ˧˦
nhúm	ɲ u m ˧˦
nhún	ɲ u n ˧˦
nhúng	ɲ ʊ w ŋ͡m ˧˦
nhăm	ɲ a m ˧˧
nhăn	ɲ a n ˧˧
nhĩ	ɲ i ˦ˀ˥
nhũn	ɲ u n ˦ˀ˥
nhơ	ɲ əː ˧˧
nhơi	ɲ əː j ˧˧
như	ɲ ɨ ˧˧
nhưng	ɲ ɨ ŋ ˧˧
nhướn	ɲ ɨ ə n ˧˦
nhường	ɲ ɨ ə ŋ ˨˩
nhượng	ɲ ɨ ə ŋ ˧˨ ʔ
nhạc	ɲ aː k̚ ˧˨ ʔ
nhại	ɲ aː j ˧˨ ʔ
nhạn	ɲ aː n ˧˨ ʔ
nhạo	ɲ aː w ˧˨ ʔ
nhạt	ɲ aː t̚ ˧˨ ʔ
nhạy	ɲ a j ˧˨ ʔ
nhả	ɲ aː ˧˩
nhảm	ɲ aː m ˧˩
nhảy	ɲ a j ˧˩
nhấc	ɲ ə k̚ ˧˦
nhấm	ɲ ə m ˧˦
nhấn	ɲ ə n ˧˦
nhấp	ɲ ə p̚ ˧˦
nhất	ɲ ə t̚ ˧˦
nhầm	ɲ ə m ˨˩
nhầy	ɲ ə j ˨˩
nhẩm	ɲ ə m ˧˩
nhẫn	ɲ ə n ˦ˀ˥
nhận	ɲ ə n ˧˨ ʔ
nhập	ɲ ə p̚ ˧˨ ʔ
nhật	ɲ ə t̚ ˧˨ ʔ
nhậu	ɲ ə w ˧˨ ʔ
nhắc	ɲ a k̚ ˧˦
nhắm	ɲ a m ˧˦
nhắn	ɲ a n ˧˦
nhắt	ɲ a t̚ ˧˦
nhằm	ɲ a m ˨˩
nhằn	ɲ a n ˨˩
nhẵn	ɲ a n ˦ˀ˥
nhặng	ɲ a ŋ ˧˨ ʔ
nhặt	ɲ a t̚ ˧˨ ʔ
nhẹ	ɲ ɛ ˧˨ ʔ
nhếch	ɲ ə j k̟̚ ˧˦
nhể	ɲ e ˧˩
nhện	ɲ e n ˧˨ ʔ
nhỉ	ɲ i ˧˩
nhỉnh	ɲ ï ŋ ˧˩
nhị	ɲ i ˧˨ ʔ
nhịn	ɲ i n ˧˨ ʔ
nhịp	ɲ i p̚ ˧˨ ʔ
nhọ	ɲ ɔ ˧˨ ʔ
nhọc	ɲ a w k͡p̚ ˧˨ ʔ
nhọn	ɲ ɔ n ˧˨ ʔ
nhọt	ɲ ɔ t̚ ˧˨ ʔ
nhỏ	ɲ ɔ ˧˩
nhỏng	ɲ a w ŋ͡m ˧˩
nhốt	ɲ o t̚ ˧˦
nhồi	ɲ o j ˨˩
nhổ	ɲ o ˧˩
nhổm	ɲ o m ˧˩
nhộn	ɲ o n ˧˨ ʔ
nhộng	ɲ ə w ŋ͡m ˧˨ ʔ
nhột	ɲ o t̚ ˧˨ ʔ
nhớ	ɲ əː ˧˦
nhớn	ɲ əː n ˧˦
nhớp	ɲ əː p̚ ˧˦
nhớt	ɲ əː t̚ ˧˦
nhờ	ɲ əː ˨˩
nhời	ɲ əː j ˨˩
nhờn	ɲ əː n ˨˩
nhởi	ɲ əː j ˧˩
nhỡ	ɲ əː ˦ˀ˥
nhợn	ɲ əː n ˧˨ ʔ
nhục	ɲ ʊ w k͡p̚ ˧˨ ʔ
nhủ	ɲ u ˧˩
nhủi	ɲ u j ˧˩
nhức	ɲ ɨ k̚ ˧˦
nhừ	ɲ ɨ ˨˩
nhử	ɲ ɨ ˧˩
những	ɲ ɨ ŋ ˦ˀ˥
nhựa	ɲ ɨ ə ˧˨ ʔ
ni	n i ˧˧
niken	n i ˧˧ k ɛ n ˧˧
ninh	n ï ŋ ˧˧
niobi	n i ˧˧ ʔ o ˧˧ ʔ ɓ i ˧˧
nitơ	n i ˧˧ t əː ˧˧
niên	n i ə n ˧˧
niêu	n i ə w ˧˧
niềm	n i ə m ˨˩
niền	n i ə n ˨˩
niềng	n i ə ŋ ˨˩
niễng	n i ə ŋ ˦ˀ˥
niệt	n i ə t̚ ˧˨ ʔ
no	n ɔ ˧˧
nobeli	n o ˧˧ ʔ ɓ e ˧˧ l i ˧˧
noi	n ɔ j ˧˧
nom	n ɔ m ˧˧
non	n ɔ n ˧˧
nong	n a w ŋ͡m ˧˧
noãn	n w aː n ˦ˀ˥
nui	n u j ˧˧
nung	n ʊ w ŋ͡m ˧˧
nuy	n w i ˧˧
nuôi	n u ə j ˧˧
nuối	n u ə j ˧˦
nuốt	n u ə t̚ ˧˦
nuột	n u ə t̚ ˧˨ ʔ
nxb	ɲ aː ˨˩ s w ə t̚ ˧˦ ʔ ɓ aː n ˧˩
ny	n i ˧˧
nài	n aː j ˨˩
nàng	n aː ŋ ˨˩
nào	n aː w ˨˩
này	n a j ˨˩
ná	n aː ˧˦
nách	n a j k̟̚ ˧˦
nái	n aː j ˧˦
nám	n aː m ˧˦
nán	n aː n ˧˦
náng	n aː ŋ ˧˦
nát	n aː t̚ ˧˦
náu	n a w ˧˦
nâng	n ə ŋ ˧˧
nâu	n ə w ˧˧
nã	n aː ˦ˀ˥
não	n aː w ˦ˀ˥
nãy	n a j ˦ˀ˥
nè	n ɛ ˨˩
né	n ɛ ˧˦
ném	n ɛ m ˧˦
nén	n ɛ n ˧˦
nép	n ɛ p̚ ˧˦
nét	n ɛ t̚ ˧˦
nê	n e ˧˧
nêm	n e m ˧˧
nên	n e n ˧˧
nêu	n e w ˧˧
ních	n ï k̟̚ ˧˦
nín	n i n ˧˦
níu	n i w ˧˦
nòi	n ɔ j ˨˩
nòng	n a w ŋ͡m ˨˩
nó	n ɔ ˧˦
nóc	n a w k͡p̚ ˧˦
nói	n ɔ j ˧˦
nón	n ɔ n ˧˦
nóng	n a w ŋ͡m ˧˦
nôi	n o j ˧˧
nôm	n o m ˧˧
nôn	n o n ˧˧
nông	n ə w ŋ͡m ˧˧
nõ	n ɔ ˦ˀ˥
nõn	n ɔ n ˦ˀ˥
nùi	n u j ˨˩
nùng	n ʊ w ŋ͡m ˨˩
núc	n ʊ w k͡p̚ ˧˦
núi	n u j ˧˦
núm	n u m ˧˦
núp	n u p̚ ˧˦
nút	n u t̚ ˧˦
năm	n a m ˧˧
năng	n a ŋ ˧˧
nĩa	n i ə ˦ˀ˥
nơ	n əː ˧˧
nơi	n əː j ˧˧
nơtron	n əː ˧˧ t͡ɕ ə w ŋ͡m ˧˧
nương	n ɨ ə ŋ ˧˧
nước	n ɨ ə k̚ ˧˦
nướng	n ɨ ə ŋ ˧˦
nướu	n i ə w ˧˦
nạ	n aː ˧˨ ʔ
nạc	n aː k̚ ˧˨ ʔ
nạm	n aː m ˧˨ ʔ
nạn	n aː n ˧˨ ʔ
nạng	n aː ŋ ˧˨ ʔ
nạo	n aː w ˧˨ ʔ
nạp	n aː p̚ ˧˨ ʔ
nạt	n aː t̚ ˧˨ ʔ
nạy	n a j ˧˨ ʔ
nải	n aː j ˧˩
nản	n aː n ˧˩
nảy	n a j ˧˩
nấc	n ə k̚ ˧˦
nấm	n ə m ˧˦
nấp	n ə p̚ ˧˦
nấu	n ə w ˧˦
nấy	n ə j ˧˦
nầy	n ə j ˨˩
nẩu	n ə w ˧˩
nẫu	n ə w ˦ˀ˥
nậy	n ə j ˧˨ ʔ
nắm	n a m ˧˦
nắn	n a n ˧˦
nắng	n a ŋ ˧˦
nắp	n a p̚ ˧˦
nằm	n a m ˨˩
nẳm	n a m ˧˩
nặc	n a k̚ ˧˨ ʔ
nặn	n a n ˧˨ ʔ
nặng	n a ŋ ˧˨ ʔ
nẹp	n ɛ p̚ ˧˨ ʔ
nẻ	n ɛ ˧˩
nẻo	n ɛ w ˧˩
nếm	n e m ˧˦
nến	n e n ˧˦
nếp	n e p̚ ˧˦
nết	n e t̚ ˧˦
nếu	n e w ˧˦
nền	n e n ˨˩
nể	n e ˧˩
nệm	n e m ˧˨ ʔ
nện	n e n ˧˨ ʔ
nịch	n ï k̟̚ ˧˨ ʔ
nịnh	n ï ŋ ˧˨ ʔ
nịt	n i t̚ ˧˨ ʔ
nọ	n ɔ ˧˨ ʔ
nọc	n a w k͡p̚ ˧˨ ʔ
nọng	n a w ŋ͡m ˧˨ ʔ
nỏ	n ɔ ˧˩
nốc	n ə w k͡p̚ ˧˦
nối	n o j ˧˦
nốt	n o t̚ ˧˦
nồi	n o j ˨˩
nồng	n ə w ŋ͡m ˨˩
nổ	n o ˧˩
nổi	n o j ˧˩
nỗi	n o j ˦ˀ˥
nội	n o j ˧˨ ʔ
nộm	n o m ˧˨ ʔ
nộp	n o p̚ ˧˨ ʔ
nớ	n əː ˧˦
nới	n əː j ˧˦
nở	n əː ˧˩
nỡ	n əː ˦ˀ˥
nợ	n əː ˧˨ ʔ
nụ	n u ˧˨ ʔ
nứa	n ɨ ə ˧˦
nứng	n ɨ ŋ ˧˦
nứt	n ɨ t̚ ˧˦
nừng	n ɨ ŋ ˨˩
nửa	n ɨ ə ˧˩
nữ	n ɨ ˦ˀ˥
nữa	n ɨ ə ˦ˀ˥
nực	n ɨ k̚ ˧˨ ʔ
nựng	n ɨ ŋ ˧˨ ʔ
o	ʔ ɔ ˧˧
oai	ʔ w aː j ˧˧
obitan	ʔ ɔ ˧˧ ʔ ɓ i ˧˧ t aː n ˧˧
oi	ʔ ɔ j ˧˧
om	ʔ ɔ m ˧˧
ong	ʔ a w ŋ͡m ˧˧
osimi	ʔ o ˧˧ s i ˧˧ m i ˧˧
oxi	ʔ o ˧˧ s i ˧˧
oà	ʔ w aː ˨˩
oách	ʔ w a j k̟̚ ˧˦
oóc	ʔ ɔ k̚ ˧˦
oải	ʔ w aː j ˧˩
oắt	ʔ w a t̚ ˧˦
oằn	ʔ w a n ˨˩
oẳng	ʔ w a ŋ ˧˩
oặt	ʔ w a t̚ ˧˨ ʔ
p	p e ˧˧
palađi	p aː ˧˧ l aː ˧˧ ʔ ɗ i ˧˧
panh	p a j ŋ̟ ˧˧
pao	p aː w ˧˧
parabol	p aː ˧˧ ɹ aː ˧˧ ʔ ɓ ɔ n ˧˧
patriciô	p aː ˧˧ t͡ɕ i ˧˧ s i ˧˧ ʔ o ˧˧
pha	f aː ˧˧
phai	f aː j ˧˧
phan	f aː n ˧˧
phang	f aː ŋ ˧˧
phanh	f a j ŋ̟ ˧˧
phanxicô	f aː n ˧˧ s i ˧˧ k o ˧˧
phao	f aː w ˧˧
phaolô	f aː w ˧˧ l o ˧˧
phau	f a w ˧˧
phe	f ɛ ˧˧
phen	f ɛ n ˧˧
phi	f i ˧˧
philípphê	f i ˧˧ l i p̚ ˧˦ f e ˧˧
phim	f i m ˧˧
phin	f i n ˧˧
phiên	f i ə n ˧˧
phiếm	f i ə m ˧˦
phiến	f i ə n ˧˦
phiếu	f i ə w ˧˦
phiền	f i ə n ˨˩
pho	f ɔ ˧˧
phoi	f ɔ j ˧˧
phong	f a w ŋ͡m ˧˧
photpho	f o t̚ ˧˦ f ɔ ˧˧
phun	f u n ˧˧
phuy	f w i ˧˧
phà	f aː ˨˩
phàm	f aː m ˨˩
phá	f aː ˧˦
phác	f aː k̚ ˧˦
phách	f a j k̟̚ ˧˦
phái	f aː j ˧˦
pháo	f aː w ˧˦
pháp	f aː p̚ ˧˦
phát	f aː t̚ ˧˦
phân	f ə n ˧˧
phây	f ə j ˧˧
phè	f ɛ ˨˩
phèn	f ɛ n ˨˩
phèo	f ɛ w ˨˩
phép	f ɛ p̚ ˧˦
phê	f e ˧˧
phên	f e n ˧˧
phêrô	f e ˧˧ z o ˧˧
phình	f ï ŋ ˨˩
phí	f i ˧˦
phía	f i ə ˧˦
phích	f ï k̟̚ ˧˦
phím	f i m ˧˦
phò	f ɔ ˨˩
phòi	f ɔ j ˨˩
phòng	f a w ŋ͡m ˨˩
phó	f ɔ ˧˦
phóng	f a w ŋ͡m ˧˦
phôi	f o j ˧˧
phông	f ə w ŋ͡m ˧˧
phù	f u ˨˩
phùn	f u n ˨˩
phùng	f ʊ w ŋ͡m ˨˩
phú	f u ˧˦
phúc	f ʊ w k͡p̚ ˧˦
phút	f u t̚ ˧˦
phũ	f u ˦ˀ˥
phơi	f əː j ˧˧
phương	f ɨ ə ŋ ˧˧
phước	f ɨ ə k̚ ˧˦
phường	f ɨ ə ŋ ˨˩
phượng	f ɨ ə ŋ ˧˨ ʔ
phượt	f ɨ ə t̚ ˧˨ ʔ
phạm	f aː m ˧˨ ʔ
phạt	f aː t̚ ˧˨ ʔ
phả	f aː ˧˩
phải	f aː j ˧˩
phản	f aː n ˧˩
phấn	f ə n ˧˦
phất	f ə t̚ ˧˦
phần	f ə n ˨˩
phẩm	f ə m ˧˩
phẩy	f ə j ˧˩
phẫu	f ə w ˦ˀ˥
phận	f ə n ˧˨ ʔ
phật	f ə t̚ ˧˨ ʔ
phẳng	f a ŋ ˧˩
phế	f e ˧˦
phếch	f ə j k̟̚ ˧˦
phết	f e t̚ ˧˦
phễu	f e w ˦ˀ˥
phệ	f e ˧˨ ʔ
phỉ	f i ˧˩
phỉnh	f ï ŋ ˧˩
phị	f i ˧˨ ʔ
phịch	f ï k̟̚ ˧˨ ʔ
phọt	f ɔ t̚ ˧˨ ʔ
phỏng	f a w ŋ͡m ˧˩
phố	f o ˧˦
phối	f o j ˧˦
phốt	f o t̚ ˧˦
phồng	f ə w ŋ͡m ˨˩
phổ	f o ˧˩
phổi	f o j ˧˩
phới	f əː j ˧˦
phớt	f əː t̚ ˧˦
phở	f əː ˧˩
phụ	f u ˧˨ ʔ
phục	f ʊ w k͡p̚ ˧˨ ʔ
phụng	f ʊ w ŋ͡m ˧˨ ʔ
phụt	f u t̚ ˧˨ ʔ
phủ	f u ˧˩
phủi	f u j ˧˩
pin	p i n ˧˧
piô	p i ˧˧ ʔ o ˧˧
platin	p l aː ˧˧ t i n ˧˧
pleiku	p əː ˨˩ l ə j ˧˧ k u ˧˧
plutoni	p l u ˧˧ t o ˧˧ n i ˧˧
poloni	p o ˧˧ l o ˧˧ n i ˧˧
polyetylen	p ɔ ˧˧ l i ˧˧ ʔ e ˧˧ t i ˧˧ l ɛ n ˧˧
prazeođim	p ɹ aː ˧˧ z ɛ w ˧˧ ʔ ɗ i m ˧˧
prometi	p ɹ o ˧˧ m e ˧˧ t i ˧˧
protactini	ʔ u ˧˧ ɹ aː ˧˧ n i ˧˧
prôton	p ɹ o ˧˧ t ə w ŋ͡m ˧˧
pê	p e ˧˧
pích	p ï k̟̚ ˧˦
píp	p i p̚ ˧˦
pô	p o ˧˧
q	k u ˧˧
qua	k w aː ˧˧
quai	k w aː j ˧˧
quan	k w aː n ˧˧
quang	k w aː ŋ ˧˧
quanh	k w a j ŋ̟ ˧˧
quay	k w a j ˧˧
que	k w ɛ ˧˧
quen	k w ɛ n ˧˧
quy	k w i ˧˧
quyên	k w i ə n ˧˧
quyến	k w i ə n ˧˦
quyết	k w i ə t̚ ˧˦
quyền	k w i ə n ˨˩
quyển	k w i ə n ˧˩
quyện	k w i ə n ˧˨ ʔ
quyệt	k w i ə t̚ ˧˨ ʔ
quà	k w aː ˨˩
quàng	k w aː ŋ ˨˩
quành	k w a j ŋ̟ ˨˩
quào	k w aː w ˨˩
quá	k w aː ˧˦
quách	k w a j k̟̚ ˧˦
quái	k w aː j ˧˦
quán	k w aː n ˧˦
quát	k w aː t̚ ˧˦
quân	k w ə n ˧˧
quây	k w ə j ˧˧
quãng	k w aː ŋ ˦ˀ˥
què	k w ɛ ˨˩
qué	k w ɛ ˧˦
quét	k w ɛ t̚ ˧˦
quê	k w e ˧˧
quên	k w e n ˧˧
quít	k w i t̚ ˧˦
quý	k w i ˧˦
quýnh	k w ï ŋ̟ ˧˦
quýt	k w i t̚ ˧˦
quýu	k w i w ˧˦
quăn	k w a n ˧˧
quăng	k w a ŋ ˧˧
quơ	k w əː ˧˧
quạ	k w aː ˧˨ ʔ
quạc	k w aː k̚ ˧˨ ʔ
quạnh	k w a j ŋ̟ ˧˨ ʔ
quạt	k w aː t̚ ˧˨ ʔ
quạu	k w a w ˧˨ ʔ
quả	k w aː ˧˩
quản	k w aː n ˧˩
quảng	k w aː ŋ ˧˩
quảy	k w a j ˧˩
quấc	k w ə k̚ ˧˦
quấn	k w ə n ˧˦
quất	k w ə t̚ ˧˦
quấy	k w ə j ˧˦
quần	k w ə n ˨˩
quầy	k w ə j ˨˩
quẩn	k w ə n ˧˩
quẩy	k w ə j ˧˩
quẫy	k w ə j ˦ˀ˥
quận	k w ə n ˧˨ ʔ
quật	k w ə t̚ ˧˨ ʔ
quậy	k w ə j ˧˨ ʔ
quắt	k w a t̚ ˧˦
quặm	k w a m ˧˨ ʔ
quặng	k w a ŋ ˧˨ ʔ
quặt	k w a t̚ ˧˨ ʔ
quẹo	k w ɛ w ˧˨ ʔ
quẹt	k w ɛ t̚ ˧˨ ʔ
quẻ	k w ɛ ˧˩
quế	k w e ˧˦
quết	k w e t̚ ˧˦
quốc	k u ə k̚ ˧˦
quở	k w əː ˧˩
quỳ	k w i ˨˩
quỳnh	k w ï ŋ̟ ˨˩
quỵ	k w i ˧˨ ʔ
quỵt	k w i t̚ ˧˨ ʔ
quỷ	k w i ˧˩
quỹ	k w i ˦ˀ˥
r	ʔ ɛ ˧˧ z əː ˨˩
ra	z aː ˧˧
ra	ɹ aː ˧˧
ram	z aː m ˧˧
ran	z aː n ˧˧
rang	z aː ŋ ˧˧
rao	z aː w ˧˧
rau	z a w ˧˧
rađi	ɹ aː ˧˧ ʔ ɗ i ˧˧
rađon	ɹ aː ˧˧ ʔ ɗ ə w ŋ͡m ˧˧
ren	z ɛ n ˧˧
reni	ɹ e ˧˧ n i ˧˧
ri	z i ˧˧
ria	z i ə ˧˧
rinh	z ï ŋ ˧˧
riêng	z i ə ŋ ˧˧
riêu	z i ə w ˧˧
riết	z i ə t̚ ˧˦
riềng	z i ə ŋ ˨˩
riệu	z i ə w ˧˨ ʔ
roi	z ɔ j ˧˧
rong	z a w ŋ͡m ˧˧
rođi	ɹ o ˧˧ ʔ ɗ i ˧˧
ru	z u ˧˧
rubiđi	ɹ u ˧˧ ʔ ɓ i ˧˧ ʔ ɗ i ˧˧
rum	z u m ˧˧
run	z u n ˧˧
rung	z ʊ w ŋ͡m ˧˧
ruteni	ɹ u ˧˧ t e ˧˧ n i ˧˧
ruốc	z u ə k̚ ˧˦
ruồi	z u ə j ˨˩
ruộng	z u ə ŋ ˧˨ ʔ
ruột	z u ə t̚ ˧˨ ʔ
rà	z aː ˨˩
ràn	z aː n ˨˩
ràng	z aː ŋ ˨˩
rành	z a j ŋ̟ ˨˩
rào	z aː w ˨˩
rày	z a j ˨˩
rá	z aː ˧˦
rác	z aː k̚ ˧˦
rách	z a j k̟̚ ˧˦
rái	z aː j ˧˦
rán	z aː n ˧˦
ráng	z aː ŋ ˧˦
ráo	z aː w ˧˦
ráp	z aː p̚ ˧˦
rát	z aː t̚ ˧˦
ráy	z a j ˧˦
râm	z ə m ˧˧
râu	z ə w ˧˧
rây	z ə j ˧˧
rã	z aː ˦ˀ˥
rãnh	z a j ŋ̟ ˦ˀ˥
rèm	z ɛ m ˨˩
rèn	z ɛ n ˨˩
ré	z ɛ ˧˦
rén	z ɛ n ˧˦
réo	z ɛ w ˧˦
rét	z ɛ t̚ ˧˦
rê	z e ˧˧
rên	z e n ˧˧
rêu	z e w ˧˧
rìa	z i ə ˨˩
rình	z ï ŋ ˨˩
rìu	z i w ˨˩
rích	z ï k̟̚ ˧˦
rít	z i t̚ ˧˦
ríu	z i w ˧˦
rò	z ɔ ˨˩
ròm	z ɔ m ˨˩
ròng	z a w ŋ͡m ˨˩
rót	z ɔ t̚ ˧˦
rô	z o ˧˧
rông	z ə w ŋ͡m ˧˧
rõ	z ɔ ˦ˀ˥
rùa	z u ə ˨˩
rùm	z u m ˨˩
rùn	z u n ˨˩
rùng	z ʊ w ŋ͡m ˨˩
rú	z u ˧˦
rúc	z ʊ w k͡p̚ ˧˦
rún	z u n ˧˦
rút	z u t̚ ˧˦
răn	z a n ˧˧
răng	z a ŋ ˧˧
rũ	z u ˦ˀ˥
rũa	z u ə ˦ˀ˥
rơ	ɹ əː ˧˧
rơi	z əː j ˧˧
rơm	z əː m ˧˧
rơzơfođi	ɹ əː ˧˧ z əː ˧˧ f ɔ ˧˧ ʔ ɗ i ˧˧
rươi	z ɨ ə j ˧˧
rương	z ɨ ə ŋ ˧˧
rước	z ɨ ə k̚ ˧˦
rưới	z ɨ ə j ˧˦
rướm	z ɨ ə m ˧˦
rường	z ɨ ə ŋ ˨˩
rưởi	z ɨ ə j ˧˩
rưỡi	z ɨ ə j ˦ˀ˥
rượt	z ɨ ə t̚ ˧˨ ʔ
rượu	z i ə w ˧˨ ʔ
rạ	z aː ˧˨ ʔ
rạc	z aː k̚ ˧˨ ʔ
rạch	z a j k̟̚ ˧˨ ʔ
rạn	z aː n ˧˨ ʔ
rạng	z aː ŋ ˧˨ ʔ
rạp	z aː p̚ ˧˨ ʔ
rải	z aː j ˧˩
rảnh	z a j ŋ̟ ˧˩
rảy	z a j ˧˩
rấm	z ə m ˧˦
rấp	z ə p̚ ˧˦
rất	z ə t̚ ˧˦
rầm	z ə m ˨˩
rầu	z ə w ˨˩
rầy	z ə j ˨˩
rẩy	z ə j ˧˩
rẫy	z ə j ˦ˀ˥
rậm	z ə m ˧˨ ʔ
rận	z ə n ˧˨ ʔ
rập	z ə p̚ ˧˨ ʔ
rắc	z a k̚ ˧˦
rắm	z a m ˧˦
rắn	z a n ˧˦
rắp	z a p̚ ˧˦
rằm	z a m ˨˩
rằn	z a n ˨˩
rằng	z a ŋ ˨˩
rặn	z a n ˧˨ ʔ
rặng	z a ŋ ˧˨ ʔ
rẻ	z ɛ ˧˩
rẻo	z ɛ w ˧˩
rẽ	z ɛ ˦ˀ˥
rế	z e ˧˦
rếch	z ə j k̟̚ ˧˦
rết	z e t̚ ˧˦
rề	z e ˨˩
rền	z e n ˨˩
rể	z e ˧˩
rễ	z e ˦ˀ˥
rệ	z e ˧˨ ʔ
rệp	z e p̚ ˧˨ ʔ
rỉ	z i ˧˩
rỉa	z i ə ˧˩
rọ	z ɔ ˧˨ ʔ
rọc	z a w k͡p̚ ˧˨ ʔ
rọi	z ɔ j ˧˨ ʔ
rối	z o j ˧˦
rốn	z o n ˧˦
rống	z ə w ŋ͡m ˧˦
rốt	z o t̚ ˧˦
rồ	z o ˨˩
rồi	z o j ˨˩
rồng	z ə w ŋ͡m ˨˩
rổ	z o ˧˩
rỗi	z o j ˦ˀ˥
rỗng	z ə w ŋ͡m ˦ˀ˥
rộ	z o ˧˨ ʔ
rộn	z o n ˧˨ ʔ
rộng	z ə w ŋ͡m ˧˨ ʔ
rớ	z əː ˧˦
rớm	z əː m ˧˦
rớt	z əː t̚ ˧˦
rờ	z əː ˨˩
rời	z əː j ˨˩
rởm	z əː m ˧˩
rỡ	z əː ˦ˀ˥
rợ	z əː ˧˨ ʔ
rợn	z əː n ˧˨ ʔ
rợp	z əː p̚ ˧˨ ʔ
rục	z ʊ w k͡p̚ ˧˨ ʔ
rụng	z ʊ w ŋ͡m ˧˨ ʔ
rụt	z u t̚ ˧˨ ʔ
rủ	z u ˧˩
rủa	z u ə ˧˩
rủi	z u j ˧˩
rứa	z ɨ ə ˧˦
rứt	z ɨ t̚ ˧˦
rừng	z ɨ ŋ ˨˩
rử	z ɨ ˧˩
rửa	z ɨ ə ˧˩
rữa	z ɨ ə ˦ˀ˥
rựa	z ɨ ə ˧˨ ʔ
rực	z ɨ k̚ ˧˨ ʔ
s	ʔ ɛ t̚ ˧˦ s i ˨˩
sa	s aː ˧˧
sai	s aː j ˧˧
sam	s aː m ˧˧
samari	s aː ˧˧ m aː ˧˧ ɹ i ˧˧
san	s aː n ˧˧
sang	s aː ŋ ˧˧
sanh	s a j ŋ̟ ˧˧
sao	s aː w ˧˧
sau	s a w ˧˧
say	s a j ˧˧
scanđi	s k aː n ˧˧ ʔ ɗ i ˧˧
selen	s e ˧˧ l ɛ n ˧˧
sen	s ɛ n ˧˧
seo	s ɛ w ˧˧
si	s i ˧˧
sida	s i ˧˧ ʔ ɗ aː ˧˧
silic	s i ˧˧ l ï k̟̚ ˧˦
sim	s i m ˧˧
simon	s i ˧˧ m ɔ n ˧˧
sin	s i n ˧˧
sinh	s ï ŋ ˧˧
siêu	s i ə w ˧˧
siết	s i ə t̚ ˧˦
so	s ɔ ˧˧
soi	s ɔ j ˧˧
son	s ɔ n ˧˧
song	s a w ŋ͡m ˧˧
soát	s w aː t̚ ˧˦
soóc	s ɔ k̚ ˧˦
soạn	s w aː n ˧˨ ʔ
soọc	s ɔ k̚ ˧˨ ʔ
spam	s p a m ˧˧
stibi	s t i ˧˧ ʔ ɓ i ˧˧
stronti	s t ɹ ɔ n ˧˧ t i ˧˧
stêphanô	s t e ˧˧ f aː n ˧˧ n o ˧˧
sui	s u j ˧˧
sun	s u n ˧˧
sung	s ʊ w ŋ͡m ˧˧
suy	s w i ˧˧
suyễn	s w i ə n ˦ˀ˥
suôn	s u ə n ˧˧
suýt	s w i t̚ ˧˦
suất	s w ə t̚ ˧˦
suối	s u ə j ˧˦
suốt	s u ə t̚ ˧˦
suỵt	s w i t̚ ˧˨ ʔ
sylvestrô	s i w ˧˧ v ɛ t̚ ˧˦ s t ɹ o ˧˧
sài	s aː j ˨˩
sàn	s aː n ˨˩
sàng	s aː ŋ ˨˩
sành	s a j ŋ̟ ˨˩
sào	s aː w ˨˩
sá	s aː ˧˦
sách	s a j k̟̚ ˧˦
sái	s aː j ˧˦
sán	s aː n ˧˦
sáng	s aː ŋ ˧˦
sánh	s a j ŋ̟ ˧˦
sáo	s aː w ˧˦
sáp	s aː p̚ ˧˦
sát	s aː t̚ ˧˦
sáu	s a w ˧˦
sâm	s ə m ˧˧
sân	s ə n ˧˧
sâu	s ə w ˧˧
sãi	s aː j ˦ˀ˥
séc	s ɛ k̚ ˧˦
sét	s ɛ t̚ ˧˦
sên	s e n ˧˧
sênh	s ə j ŋ̟ ˧˧
sêvêrinô	s e ˧˧ v e ˧˧ z i ˧˧ n o ˧˧
sình	s ï ŋ ˨˩
sính	s ï ŋ ˧˦
síp	s i p̚ ˧˦
sít	s i t̚ ˧˦
sò	s ɔ ˨˩
sòng	s a w ŋ͡m ˨˩
sóc	s a w k͡p̚ ˧˦
sói	s ɔ j ˧˦
sóng	s a w ŋ͡m ˧˦
sót	s ɔ t̚ ˧˦
sô	s o ˧˧
sôi	s o j ˧˧
sông	s ə w ŋ͡m ˧˧
sõi	s ɔ j ˦ˀ˥
sùng	s ʊ w ŋ͡m ˨˩
sú	s u ˧˦
súc	s ʊ w k͡p̚ ˧˦
sún	s u n ˧˦
súng	s ʊ w ŋ͡m ˧˦
sút	s u t̚ ˧˦
săm	s a m ˧˧
săn	s a n ˧˧
sĩ	s i ˦ˀ˥
sũng	s ʊ w ŋ͡m ˦ˀ˥
sơ	s əː ˧˧
sơn	s əː n ˧˧
sư	s ɨ ˧˧
sưa	s ɨ ə ˧˧
sưng	s ɨ ŋ ˧˧
sưu	s i w ˧˧
sương	s ɨ ə ŋ ˧˧
sướng	s ɨ ə ŋ ˧˦
sườn	s ɨ ə n ˨˩
sưởi	s ɨ ə j ˧˩
sượng	s ɨ ə ŋ ˧˨ ʔ
sạc	s aː k̚ ˧˨ ʔ
sạch	s a j k̟̚ ˧˨ ʔ
sạn	s aː n ˧˨ ʔ
sạt	s aː t̚ ˧˨ ʔ
sả	s aː ˧˩
sải	s aː j ˧˩
sản	s aː n ˧˩
sảo	s aː w ˧˩
sấm	s ə m ˧˦
sấp	s ə p̚ ˧˦
sấu	s ə w ˧˦
sấy	s ə j ˧˦
sầu	s ə w ˨˩
sầy	s ə j ˨˩
sẩy	s ə j ˧˩
sẫm	s ə m ˦ˀ˥
sậm	s ə m ˧˨ ʔ
sập	s ə p̚ ˧˨ ʔ
sậy	s ə j ˧˨ ʔ
sắc	s a k̚ ˧˦
sắm	s a m ˧˦
sắn	s a n ˧˦
sắp	s a p̚ ˧˦
sắt	s a t̚ ˧˦
sẵn	s a n ˦ˀ˥
sặc	s a k̚ ˧˨ ʔ
sẹo	s ɛ w ˧˨ ʔ
sẻ	s ɛ ˧˩
sẽ	s ɛ ˦ˀ˥
sến	s e n ˧˦
sếp	s e p̚ ˧˦
sếu	s e w ˧˦
sệt	s e t̚ ˧˨ ʔ
sỉ	s i ˧˩
sỉa	s i ə ˧˩
sọ	s ɔ ˧˨ ʔ
sọc	s a w k͡p̚ ˧˨ ʔ
sọt	s ɔ t̚ ˧˨ ʔ
sỏ	s ɔ ˧˩
sỏi	s ɔ j ˧˩
số	s o ˧˦
sốc	s ə w k͡p̚ ˧˦
sống	s ə w ŋ͡m ˧˦
sốt	s o t̚ ˧˦
sồi	s o j ˨˩
sổ	s o ˧˩
sổng	s ə w ŋ͡m ˧˩
sớm	s əː m ˧˦
sớt	s əː t̚ ˧˦
sờ	s əː ˨˩
sờn	s əː n ˨˩
sở	s əː ˧˩
sởi	s əː j ˧˩
sởn	s əː n ˧˩
sợ	s əː ˧˨ ʔ
sợi	s əː j ˧˨ ʔ
sục	s ʊ w k͡p̚ ˧˨ ʔ
sụn	s u n ˧˨ ʔ
sụp	s u p̚ ˧˨ ʔ
sụt	s u t̚ ˧˨ ʔ
sủa	s u ə ˧˩
sủi	s u j ˧˩
sứ	s ɨ ˧˦
sứa	s ɨ ə ˧˦
sức	s ɨ k̚ ˧˦
sứt	s ɨ t̚ ˧˦
sừng	s ɨ ŋ ˨˩
sử	s ɨ ˧˩
sửa	s ɨ ə ˧˩
sửu	s i w ˧˩
sữa	s ɨ ə ˦ˀ˥
sững	s ɨ ŋ ˦ˀ˥
sự	s ɨ ˧˨ ʔ
sực	s ɨ k̚ ˧˨ ʔ
t	t e ˧˧
ta	t aː ˧˧
tai	t aː j ˧˧
tali	t aː ˧˧ l i ˧˧
tam	t aː m ˧˧
tan	t aː n ˧˧
tang	t aː ŋ ˧˧
tanh	t a j ŋ̟ ˧˧
tantan	t aː n ˧˧ t aː n ˧˧
tao	t aː w ˧˧
tau	t a w ˧˧
tay	t a j ˧˧
tađêô	t aː ˧˧ ʔ ɗ e ˧˧ ʔ o ˧˧
tcn	t͡ɕ ɨ ə k̚ ˧˦ k ə w ŋ͡m ˧˧ ŋ w i ə n ˧˧
tebi	t ɛ ˧˧ ʔ ɓ i ˧˧
tecnexi	t ɛ k̚ ˧˦ n e ˧˧ s i ˧˧
telex	t e ˧˧ l ə j k̟̚ ˧˦
telu	t ɛ ˧˧ l u ˧˧
tem	t ɛ m ˧˧
teo	t ɛ w ˧˧
tgp	t ə w ŋ͡m ˧˩ z aː w ˧˦ f ə n ˧˨ ʔ
tha	tʰ aː ˧˧
thai	tʰ aː j ˧˧
tham	tʰ aː m ˧˧
than	tʰ aː n ˧˧
thang	tʰ aː ŋ ˧˧
thanh	tʰ a j ŋ̟ ˧˧
thau	tʰ a w ˧˧
thay	tʰ a j ˧˧
thcs	t͡ɕ ʊ w ŋ͡m ˧˧ h a w k͡p̚ ˧˨ ʔ k əː ˧˧ s əː ˧˩
the	tʰ ɛ ˧˧
then	tʰ ɛ n ˧˧
theo	tʰ ɛ w ˧˧
thi	tʰ i ˧˧
thinh	tʰ ï ŋ ˧˧
thiu	tʰ i w ˧˧
thiên	tʰ i ə n ˧˧
thiêng	tʰ i ə ŋ ˧˧
thiêu	tʰ i ə w ˧˧
thiếc	tʰ i ə k̚ ˧˦
thiến	tʰ i ə n ˧˦
thiếp	tʰ i ə p̚ ˧˦
thiết	tʰ i ə t̚ ˧˦
thiếu	tʰ i ə w ˧˦
thiền	tʰ i ə n ˨˩
thiện	tʰ i ə n ˧˨ ʔ
thiệt	tʰ i ə t̚ ˧˨ ʔ
thoa	tʰ w aː ˧˧
thoi	tʰ ɔ j ˧˧
thon	tʰ ɔ n ˧˧
thori	tʰ ɔ ˧˧ ɹ i ˧˧
thoáng	tʰ w aː ŋ ˧˦
thoát	tʰ w aː t̚ ˧˦
thoại	tʰ w aː j ˧˨ ʔ
thoạt	tʰ w aː t̚ ˧˨ ʔ
thoả	tʰ w aː ˧˩
thoải	tʰ w aː j ˧˩
thoảng	tʰ w aː ŋ ˧˩
thpt	t͡ɕ ʊ w ŋ͡m ˧˧ h a w k͡p̚ ˧˨ ʔ f o ˧˩ tʰ ə w ŋ͡m ˧˧
thu	tʰ u ˧˧
thua	tʰ u ə ˧˧
thui	tʰ u j ˧˧
thun	tʰ u n ˧˧
thung	tʰ ʊ w ŋ͡m ˧˧
thuyết	tʰ w i ə t̚ ˧˦
thuyền	tʰ w i ə n ˨˩
thuê	tʰ w e ˧˧
thuôn	tʰ u ə n ˧˧
thuý	tʰ w i ˧˦
thuần	tʰ w ə n ˨˩
thuận	tʰ w ə n ˧˨ ʔ
thuật	tʰ w ə t̚ ˧˨ ʔ
thuế	tʰ w e ˧˦
thuốc	tʰ u ə k̚ ˧˦
thuổng	tʰ u ə ŋ ˧˩
thuộc	tʰ u ə k̚ ˧˨ ʔ
thuở	tʰ w əː ˧˩
thuỳ	tʰ w i ˨˩
thuỵ	tʰ w i ˧˨ ʔ
thuỷ	tʰ w i ˧˩
thà	tʰ aː ˨˩
thành	tʰ a j ŋ̟ ˨˩
thác	tʰ aː k̚ ˧˦
thách	tʰ a j k̟̚ ˧˦
thái	tʰ aː j ˧˦
tháng	tʰ aː ŋ ˧˦
thánh	tʰ a j ŋ̟ ˧˦
tháo	tʰ aː w ˧˦
tháp	tʰ aː p̚ ˧˦
tháu	tʰ a w ˧˦
thâm	tʰ ə m ˧˧
thân	tʰ ə n ˧˧
thâu	tʰ ə w ˧˧
thây	tʰ ə j ˧˧
thè	tʰ ɛ ˨˩
thèm	tʰ ɛ m ˨˩
thép	tʰ ɛ p̚ ˧˦
thêm	tʰ e m ˧˧
thêu	tʰ e w ˧˧
thêôđorô	tʰ e ˧˧ ʔ o ˧˧ ʔ ɗ ɔ ˧˧ z o ˧˧
thì	tʰ i ˨˩
thìa	tʰ i ə ˨˩
thìn	tʰ i n ˨˩
thí	tʰ i ˧˦
thích	tʰ ï k̟̚ ˧˦
thím	tʰ i m ˧˦
thính	tʰ ï ŋ ˧˦
thò	tʰ ɔ ˨˩
thòng	tʰ a w ŋ͡m ˨˩
thóc	tʰ a w k͡p̚ ˧˦
thói	tʰ ɔ j ˧˦
thóp	tʰ ɔ p̚ ˧˦
thô	tʰ o ˧˧
thôi	tʰ o j ˧˧
thôn	tʰ o n ˧˧
thông	tʰ ə w ŋ͡m ˧˧
thù	tʰ u ˨˩
thùa	tʰ u ə ˨˩
thùng	tʰ ʊ w ŋ͡m ˨˩
thú	tʰ u ˧˦
thúc	tʰ ʊ w k͡p̚ ˧˦
thúi	tʰ u j ˧˦
thúng	tʰ ʊ w ŋ͡m ˧˦
thăm	tʰ a m ˧˧
thăn	tʰ a n ˧˧
thăng	tʰ a ŋ ˧˧
thơ	tʰ əː ˧˧
thơm	tʰ əː m ˧˧
thư	tʰ ɨ ˧˧
thưa	tʰ ɨ ə ˧˧
thương	tʰ ɨ ə ŋ ˧˧
thước	tʰ ɨ ə k̚ ˧˦
thường	tʰ ɨ ə ŋ ˨˩
thưởng	tʰ ɨ ə ŋ ˧˩
thượng	tʰ ɨ ə ŋ ˧˨ ʔ
thạch	tʰ a j k̟̚ ˧˨ ʔ
thạo	tʰ aː w ˧˨ ʔ
thả	tʰ aː ˧˩
thải	tʰ aː j ˧˩
thảm	tʰ aː m ˧˩
thảo	tʰ aː w ˧˩
thảy	tʰ a j ˧˩
thấm	tʰ ə m ˧˦
thấp	tʰ ə p̚ ˧˦
thất	tʰ ə t̚ ˧˦
thấu	tʰ ə w ˧˦
thấy	tʰ ə j ˧˦
thầm	tʰ ə m ˨˩
thần	tʰ ə n ˨˩
thầu	tʰ ə w ˨˩
thầy	tʰ ə j ˨˩
thẩy	tʰ ə j ˧˩
thận	tʰ ə n ˧˨ ʔ
thập	tʰ ə p̚ ˧˨ ʔ
thật	tʰ ə t̚ ˧˨ ʔ
thắm	tʰ a m ˧˦
thắng	tʰ a ŋ ˧˦
thắp	tʰ a p̚ ˧˦
thắt	tʰ a t̚ ˧˦
thằng	tʰ a ŋ ˨˩
thẳm	tʰ a m ˧˩
thẳng	tʰ a ŋ ˧˩
thẹn	tʰ ɛ n ˧˨ ʔ
thẹo	tʰ ɛ w ˧˨ ʔ
thẻ	tʰ ɛ ˧˩
thế	tʰ e ˧˦
thề	tʰ e ˨˩
thềm	tʰ e m ˨˩
thể	tʰ e ˧˩
thị	tʰ i ˧˨ ʔ
thịch	tʰ ï k̟̚ ˧˨ ʔ
thịnh	tʰ ï ŋ ˧˨ ʔ
thịt	tʰ i t̚ ˧˨ ʔ
thọ	tʰ ɔ ˧˨ ʔ
thọc	tʰ a w k͡p̚ ˧˨ ʔ
thọt	tʰ ɔ t̚ ˧˨ ʔ
thỏ	tʰ ɔ ˧˩
thối	tʰ o j ˧˦
thốn	tʰ o n ˧˦
thống	tʰ ə w ŋ͡m ˧˦
thốt	tʰ o t̚ ˧˦
thồn	tʰ o n ˨˩
thổ	tʰ o ˧˩
thổi	tʰ o j ˧˩
thớt	tʰ əː t̚ ˧˦
thờ	tʰ əː ˨˩
thời	tʰ əː j ˨˩
thở	tʰ əː ˧˩
thợ	tʰ əː ˧˨ ʔ
thụ	tʰ u ˧˨ ʔ
thục	tʰ ʊ w k͡p̚ ˧˨ ʔ
thụt	tʰ u t̚ ˧˨ ʔ
thủ	tʰ u ˧˩
thủa	tʰ u ə ˧˩
thủm	tʰ u m ˧˩
thủng	tʰ ʊ w ŋ͡m ˧˩
thứ	tʰ ɨ ˧˦
thức	tʰ ɨ k̚ ˧˦
thừ	tʰ ɨ ˨˩
thừa	tʰ ɨ ə ˨˩
thừng	tʰ ɨ ŋ ˨˩
thử	tʰ ɨ ˧˩
thực	tʰ ɨ k̚ ˧˨ ʔ
ti	t i ˧˧
tia	t i ə ˧˧
tim	t i m ˧˧
tin	t i n ˧˧
tinh	t ï ŋ ˧˧
titan	t i ˧˧ t aː n ˧˧
tiêm	t i ə m ˧˧
tiên	t i ə n ˧˧
tiêu	t i ə w ˧˧
tiếc	t i ə k̚ ˧˦
tiến	t i ə n ˧˦
tiếng	t i ə ŋ ˧˦
tiếp	t i ə p̚ ˧˦
tiết	t i ə t̚ ˧˦
tiền	t i ə n ˨˩
tiều	t i ə w ˨˩
tiểu	t i ə w ˧˩
tiễn	t i ə n ˦ˀ˥
tiệc	t i ə k̚ ˧˨ ʔ
tiệm	t i ə m ˧˨ ʔ
tiện	t i ə n ˧˨ ʔ
tiệp	t i ə p̚ ˧˨ ʔ
to	t ɔ ˧˧
toa	t w aː ˧˧
toan	t w aː n ˧˧
toang	t w aː ŋ ˧˧
toe	t w ɛ ˧˧
toi	t ɔ j ˧˧
tong	t a w ŋ͡m ˧˧
toà	t w aː ˨˩
toàn	t w aː n ˨˩
toác	t w aː k̚ ˧˦
toán	t w aː n ˧˦
toáng	t w aː ŋ ˧˦
toát	t w aː t̚ ˧˦
toé	t w ɛ ˧˦
toét	t w ɛ t̚ ˧˦
toả	t w aː ˧˩
tp	tʰ a j ŋ̟ ˨˩ f o ˧˦
tphcm	tʰ a j ŋ̟ ˨˩ f o ˧˦ h o ˨˩ t͡ɕ i ˧˦ m ï ŋ ˧˧
tra	t͡ɕ aː ˧˧
trai	t͡ɕ aː j ˧˧
trang	t͡ɕ aː ŋ ˧˧
tranh	t͡ɕ a j ŋ̟ ˧˧
trao	t͡ɕ aː w ˧˧
trau	t͡ɕ a w ˧˧
tre	t͡ɕ ɛ ˧˧
treo	t͡ɕ ɛ w ˧˧
trinh	t͡ɕ ï ŋ ˧˧
triết	t͡ɕ i ə t̚ ˧˦
triền	t͡ɕ i ə n ˨˩
triều	t͡ɕ i ə w ˨˩
triện	t͡ɕ i ə n ˧˨ ʔ
triệt	t͡ɕ i ə t̚ ˧˨ ʔ
triệu	t͡ɕ i ə w ˧˨ ʔ
tro	t͡ɕ ɔ ˧˧
trong	t͡ɕ a w ŋ͡m ˧˧
tru	t͡ɕ u ˧˧
trung	t͡ɕ ʊ w ŋ͡m ˧˧
truy	t͡ɕ w i ˧˧
truyền	t͡ɕ w i ə n ˨˩
truyện	t͡ɕ w i ə n ˧˨ ʔ
truông	t͡ɕ u ə ŋ ˧˧
truất	t͡ɕ w ə t̚ ˧˦
truồng	t͡ɕ u ə ŋ ˨˩
trà	t͡ɕ aː ˨˩
tràm	t͡ɕ aː m ˨˩
tràn	t͡ɕ aː n ˨˩
tràng	t͡ɕ aː ŋ ˨˩
trào	t͡ɕ aː w ˨˩
trách	t͡ɕ a j k̟̚ ˧˦
trái	t͡ɕ aː j ˧˦
trám	t͡ɕ aː m ˧˦
trán	t͡ɕ aː n ˧˦
tráng	t͡ɕ aː ŋ ˧˦
tránh	t͡ɕ a j ŋ̟ ˧˦
tráo	t͡ɕ aː w ˧˦
tráp	t͡ɕ aː p̚ ˧˦
trát	t͡ɕ aː t̚ ˧˦
trâm	t͡ɕ ə m ˧˧
trân	t͡ɕ ə n ˧˧
trâu	t͡ɕ ə w ˧˧
trã	t͡ɕ aː ˦ˀ˥
trèo	t͡ɕ ɛ w ˨˩
trét	t͡ɕ ɛ t̚ ˧˦
trên	t͡ɕ e n ˧˧
trêu	t͡ɕ e w ˧˧
trình	t͡ɕ ï ŋ ˨˩
trí	t͡ɕ i ˧˦
trích	t͡ɕ ï k̟̚ ˧˦
trò	t͡ɕ ɔ ˨˩
tròn	t͡ɕ ɔ n ˨˩
tròng	t͡ɕ a w ŋ͡m ˨˩
tróc	t͡ɕ a w k͡p̚ ˧˦
trói	t͡ɕ ɔ j ˧˦
trót	t͡ɕ ɔ t̚ ˧˦
trôi	t͡ɕ o j ˧˧
trông	t͡ɕ ə w ŋ͡m ˧˧
trù	t͡ɕ u ˨˩
trùm	t͡ɕ u m ˨˩
trùn	t͡ɕ u n ˨˩
trùng	t͡ɕ ʊ w ŋ͡m ˨˩
trú	t͡ɕ u ˧˦
trúc	t͡ɕ ʊ w k͡p̚ ˧˦
trúng	t͡ɕ ʊ w ŋ͡m ˧˦
trút	t͡ɕ u t̚ ˧˦
trăm	t͡ɕ a m ˧˧
trăn	t͡ɕ a n ˧˧
trăng	t͡ɕ a ŋ ˧˧
trĩ	t͡ɕ i ˦ˀ˥
trĩu	t͡ɕ i w ˦ˀ˥
trũng	t͡ɕ ʊ w ŋ͡m ˦ˀ˥
trơ	t͡ɕ əː ˧˧
trơn	t͡ɕ əː n ˧˧
trưa	t͡ɕ ɨ ə ˧˧
trưng	t͡ɕ ɨ ŋ ˧˧
trương	t͡ɕ ɨ ə ŋ ˧˧
trước	t͡ɕ ɨ ə k̚ ˧˦
trườn	t͡ɕ ɨ ə n ˨˩
trường	t͡ɕ ɨ ə ŋ ˨˩
trưởng	t͡ɕ ɨ ə ŋ ˧˩
trượng	t͡ɕ ɨ ə ŋ ˧˨ ʔ
trượt	t͡ɕ ɨ ə t̚ ˧˨ ʔ
trạc	t͡ɕ aː k̚ ˧˨ ʔ
trại	t͡ɕ aː j ˧˨ ʔ
trạm	t͡ɕ aː m ˧˨ ʔ
trạng	t͡ɕ aː ŋ ˧˨ ʔ
trả	t͡ɕ aː ˧˩
trải	t͡ɕ aː j ˧˩
trảm	t͡ɕ aː m ˧˩
trảng	t͡ɕ aː ŋ ˧˩
trấn	t͡ɕ ə n ˧˦
trấu	t͡ɕ ə w ˧˦
trầm	t͡ɕ ə m ˨˩
trần	t͡ɕ ə n ˨˩
trầu	t͡ɕ ə w ˨˩
trầy	t͡ɕ ə j ˨˩
trẩu	t͡ɕ ə w ˧˩
trẫm	t͡ɕ ə m ˦ˀ˥
trận	t͡ɕ ə n ˧˨ ʔ
trật	t͡ɕ ə t̚ ˧˨ ʔ
trắc	t͡ɕ a k̚ ˧˦
trắm	t͡ɕ a m ˧˦
trắng	t͡ɕ a ŋ ˧˦
trặc	t͡ɕ a k̚ ˧˨ ʔ
trẹo	t͡ɕ ɛ w ˧˨ ʔ
trẻ	t͡ɕ ɛ ˧˩
trề	t͡ɕ e ˨˩
trển	t͡ɕ e n ˧˩
trễ	t͡ɕ e ˦ˀ˥
trệt	t͡ɕ e t̚ ˧˨ ʔ
trị	t͡ɕ i ˧˨ ʔ
trịnh	t͡ɕ ï ŋ ˧˨ ʔ
trọ	t͡ɕ ɔ ˧˨ ʔ
trọc	t͡ɕ a w k͡p̚ ˧˨ ʔ
trọi	t͡ɕ ɔ j ˧˨ ʔ
trọn	t͡ɕ ɔ n ˧˨ ʔ
trọng	t͡ɕ a w ŋ͡m ˧˨ ʔ
trỏ	t͡ɕ ɔ ˧˩
trỏng	t͡ɕ a w ŋ͡m ˧˩
trốc	t͡ɕ ə w k͡p̚ ˧˦
trốn	t͡ɕ o n ˧˦
trống	t͡ɕ ə w ŋ͡m ˧˦
trồi	t͡ɕ o j ˨˩
trồng	t͡ɕ ə w ŋ͡m ˨˩
trổ	t͡ɕ o ˧˩
trội	t͡ɕ o j ˧˨ ʔ
trộm	t͡ɕ o m ˧˨ ʔ
trộn	t͡ɕ o n ˧˨ ʔ
trớn	t͡ɕ əː n ˧˦
trời	t͡ɕ əː j ˨˩
trở	t͡ɕ əː ˧˩
trợn	t͡ɕ əː n ˧˨ ʔ
trụ	t͡ɕ u ˧˨ ʔ
trục	t͡ɕ ʊ w k͡p̚ ˧˨ ʔ
trụi	t͡ɕ u j ˧˨ ʔ
trụng	t͡ɕ ʊ w ŋ͡m ˧˨ ʔ
trủ	t͡ɕ u ˧˩
trứng	t͡ɕ ɨ ŋ ˧˦
trừ	t͡ɕ ɨ ˨˩
trữ	t͡ɕ ɨ ˦ˀ˥
trực	t͡ɕ ɨ k̚ ˧˨ ʔ
ttx	tʰ ə w ŋ͡m ˧˧ t ə n ˧˦ s aː ˦ˀ˥
tu	t u ˧˧
tua	t u ə ˧˧
tui	t u j ˧˧
tuli	t u ˧˧ l i ˧˧
tum	t u m ˧˧
tung	t ʊ w ŋ͡m ˧˧
tuy	t w i ˧˧
tuyến	t w i ə n ˧˦
tuyết	t w i ə t̚ ˧˦
tuyển	t w i ə n ˧˩
tuyệt	t w i ə t̚ ˧˨ ʔ
tuân	t w ə n ˧˧
tuôn	t u ə n ˧˧
tuýp	t w i p̚ ˧˦
tuấn	t w ə n ˧˦
tuất	t w ə t̚ ˧˦
tuần	t w ə n ˨˩
tuế	t w e ˧˦
tuốt	t u ə t̚ ˧˦
tuồng	t u ə ŋ ˨˩
tuổi	t u ə j ˧˩
tuột	t u ə t̚ ˧˨ ʔ
tuỳ	t w i ˨˩
tuỵ	t w i ˧˨ ʔ
tuỷ	t w i ˧˩
tv	t i ˧˧ v i ˧˧
tà	t aː ˨˩
tài	t aː j ˨˩
tàn	t aː n ˨˩
tàng	t aː ŋ ˨˩
tàu	t a w ˨˩
tày	t a j ˨˩
tá	t aː ˧˦
tách	t a j k̟̚ ˧˦
tái	t aː j ˧˦
tám	t aː m ˧˦
tán	t aː n ˧˦
táng	t aː ŋ ˧˦
tánh	t a j ŋ̟ ˧˦
táo	t aː w ˧˦
táp	t aː p̚ ˧˦
tát	t aː t̚ ˧˦
tâm	t ə m ˧˧
tân	t ə n ˧˧
tâng	t ə ŋ ˧˧
tâu	t ə w ˧˧
tây	t ə j ˧˧
tã	t aː ˦ˀ˥
tãi	t aː j ˦ˀ˥
tè	t ɛ ˨˩
té	t ɛ ˧˦
tém	t ɛ m ˧˦
tép	t ɛ p̚ ˧˦
tét	t ɛ t̚ ˧˦
tê	t e ˧˧
têhêrăng	t e ˧˧ h e ˧˧ ɹ a ŋ ˧˧
têm	t e m ˧˧
tên	t e n ˧˧
tênh	t ə j ŋ̟ ˧˧
têooc	t e ˧˧ ʔ ɔ k̚ ˧˧
têrêsa	t e ˧˧ z e ˧˧ s aː ˧˧
tìm	t i m ˨˩
tình	t ï ŋ ˨˩
tí	t i ˧˦
tía	t i ə ˧˦
tích	t ï k̟̚ ˧˦
tím	t i m ˧˦
tính	t ï ŋ ˧˦
típ	t i p̚ ˧˦
tít	t i t̚ ˧˦
tóc	t a w k͡p̚ ˧˦
tóm	t ɔ m ˧˦
tót	t ɔ t̚ ˧˦
tô	t o ˧˧
tôi	t o j ˧˧
tôm	t o m ˧˧
tôma	t o ˧˧ m aː ˧˧
tôn	t o n ˧˧
tông	t ə w ŋ͡m ˧˧
tõm	t ɔ m ˦ˀ˥
tù	t u ˨˩
tùng	t ʊ w ŋ͡m ˨˩
tú	t u ˧˦
túa	t u ə ˧˦
túi	t u j ˧˦
túm	t u m ˧˦
tút	t u t̚ ˧˦
tăm	t a m ˧˧
tăng	t a ŋ ˧˧
tơ	t əː ˧˧
tơi	t əː j ˧˧
tư	t ɨ ˧˧
tưng	t ɨ ŋ ˧˧
tươi	t ɨ ə j ˧˧
tươm	t ɨ ə m ˧˧
tương	t ɨ ə ŋ ˧˧
tước	t ɨ ə k̚ ˧˦
tưới	t ɨ ə j ˧˦
tướng	t ɨ ə ŋ ˧˦
tường	t ɨ ə ŋ ˨˩
tườu	t i ə w ˨˩
tưởng	t ɨ ə ŋ ˧˩
tượng	t ɨ ə ŋ ˧˨ ʔ
tạ	t aː ˧˨ ʔ
tạc	t aː k̚ ˧˨ ʔ
tại	t aː j ˧˨ ʔ
tạm	t aː m ˧˨ ʔ
tạng	t aː ŋ ˧˨ ʔ
tạnh	t a j ŋ̟ ˧˨ ʔ
tạo	t aː w ˧˨ ʔ
tạt	t aː t̚ ˧˨ ʔ
tả	t aː ˧˩
tải	t aː j ˧˩
tản	t aː n ˧˩
tảng	t aː ŋ ˧˩
tảo	t aː w ˧˩
tấc	t ə k̚ ˧˦
tấm	t ə m ˧˦
tấn	t ə n ˧˦
tất	t ə t̚ ˧˦
tấu	t ə w ˧˦
tầm	t ə m ˨˩
tầng	t ə ŋ ˨˩
tẩm	t ə m ˧˩
tẩn	t ə n ˧˩
tẩu	t ə w ˧˩
tẩy	t ə j ˧˩
tận	t ə n ˧˨ ʔ
tập	t ə p̚ ˧˨ ʔ
tật	t ə t̚ ˧˨ ʔ
tậu	t ə w ˧˨ ʔ
tắc	t a k̚ ˧˦
tắm	t a m ˧˦
tắp	t a p̚ ˧˦
tắt	t a t̚ ˧˦
tằm	t a m ˨˩
tặc	t a k̚ ˧˨ ʔ
tặng	t a ŋ ˧˨ ʔ
tẹo	t ɛ w ˧˨ ʔ
tẹt	t ɛ t̚ ˧˨ ʔ
tẻ	t ɛ ˧˩
tế	t e ˧˦
tếch	t ə j k̟̚ ˧˦
tết	t e t̚ ˧˦
tệ	t e ˧˨ ʔ
tệp	t e p̚ ˧˨ ʔ
tỉ	t i ˧˩
tỉa	t i ə ˧˩
tỉnh	t ï ŋ ˧˩
tị	t i ˧˨ ʔ
tịch	t ï k̟̚ ˧˨ ʔ
tịt	t i t̚ ˧˨ ʔ
tọp	t ɔ p̚ ˧˨ ʔ
tỏ	t ɔ ˧˩
tỏi	t ɔ j ˧˩
tỏm	t ɔ m ˧˩
tố	t o ˧˦
tốc	t ə w k͡p̚ ˧˦
tối	t o j ˧˦
tốn	t o n ˧˦
tống	t ə w ŋ͡m ˧˦
tốp	t o p̚ ˧˦
tốt	t o t̚ ˧˦
tồi	t o j ˨˩
tồn	t o n ˨˩
tổ	t o ˧˩
tổng	t ə w ŋ͡m ˧˩
tộ	t o ˧˨ ʔ
tộc	t ə w k͡p̚ ˧˨ ʔ
tội	t o j ˧˨ ʔ
tột	t o t̚ ˧˨ ʔ
tớ	t əː ˧˦
tới	t əː j ˧˦
tờ	t əː ˨˩
tởm	t əː m ˧˩
tởn	t əː n ˧˩
tợ	t əː ˧˨ ʔ
tợn	t əː n ˧˨ ʔ
tợp	t əː p̚ ˧˨ ʔ
tục	t ʊ w k͡p̚ ˧˨ ʔ
tụi	t u j ˧˨ ʔ
tụm	t u m ˧˨ ʔ
tụng	t ʊ w ŋ͡m ˧˨ ʔ
tụt	t u t̚ ˧˨ ʔ
tủ	t u ˧˩
tủi	t u j ˧˩
tức	t ɨ k̚ ˧˦
từ	t ɨ ˨˩
từng	t ɨ ŋ ˨˩
tử	t ɨ ˧˩
tửu	t i w ˧˩
tự	t ɨ ˧˨ ʔ
tựa	t ɨ ə ˧˨ ʔ
u	ʔ u ˧˧
ung	ʔ ʊ w ŋ͡m ˧˧
urani	ʔ u ˧˧ ɹ aː ˧˧ n i ˧˧
urbanô	ʔ w əː ˧˧ ʔ ɓ aː n ˧˧ n o ˧˧
uyên	ʔ w i ə n ˧˧
uên	ʔ w e n ˧˧
uôn	ʔ u ə n ˧˧
uý	ʔ w i ˧˦
uất	ʔ w ə t̚ ˧˦
uốn	ʔ u ə n ˧˦
uống	ʔ u ə ŋ ˧˦
uổng	ʔ u ə ŋ ˧˩
v	v e ˧˧
va	v aː ˧˧
vai	v aː j ˧˧
valentinô	v aː ˧˧ l ɛ n ˧˧ t i n ˧˧ n o ˧˧
van	v aː n ˧˧
vanađi	v aː ˧˧ n aː ˧˧ ʔ ɗ i ˧˧
vang	v aː ŋ ˧˧
vay	v a j ˧˧
ve	v ɛ ˧˧
vectơ	v ɛ k̚ ˧˦ t əː ˧˧
ven	v ɛ n ˧˧
vi	v i ˧˧
victor	v ï k̟̚ ˧˦ t ɔ ˧˧
vinh	v ï ŋ ˧˧
viêm	v i ə m ˧˧
viên	v i ə n ˧˧
viếng	v i ə ŋ ˧˦
viết	v i ə t̚ ˧˦
viền	v i ə n ˨˩
việc	v i ə k̚ ˧˨ ʔ
viện	v i ə n ˧˨ ʔ
việt	v i ə t̚ ˧˨ ʔ
vo	v ɔ ˧˧
voa	v w aː ˧˧
voan	v w aː n ˧˧
voi	v ɔ j ˧˧
vonfam	v o n ˧˧ f aː m ˧˧
voọc	v ɔ k̚ ˧˨ ʔ
vu	v u ˧˧
vua	v u ə ˧˧
vui	v u j ˧˧
vun	v u n ˧˧
vung	v ʊ w ŋ͡m ˧˧
vuông	v u ə ŋ ˧˧
vuốt	v u ə t̚ ˧˦
vuột	v u ə t̚ ˧˨ ʔ
vy	v i ˧˧
và	v aː ˨˩
vài	v aː j ˨˩
vàng	v aː ŋ ˨˩
vành	v a j ŋ̟ ˨˩
vào	v aː w ˨˩
vá	v aː ˧˦
vác	v aː k̚ ˧˦
vách	v a j k̟̚ ˧˦
vái	v aː j ˧˦
ván	v aː n ˧˦
váng	v aː ŋ ˧˦
váy	v a j ˧˦
vân	v ə n ˧˧
vâng	v ə ŋ ˧˧
vây	v ə j ˧˧
vã	v aː ˦ˀ˥
vãi	v aː j ˦ˀ˥
vè	v ɛ ˨˩
vé	v ɛ ˧˦
vén	v ɛ n ˧˦
véo	v ɛ w ˧˦
vét	v ɛ t̚ ˧˦
vê	v e ˧˧
vênh	v ə j ŋ̟ ˧˧
vì	v i ˨˩
ví	v i ˧˦
vía	v i ə ˧˦
vích	v ï k̟̚ ˧˦
vít	v i t̚ ˧˦
víu	v i w ˧˦
vò	v ɔ ˨˩
vòi	v ɔ j ˨˩
vòm	v ɔ m ˨˩
vòng	v a w ŋ͡m ˨˩
vó	v ɔ ˧˦
vóc	v a w k͡p̚ ˧˦
vón	v ɔ n ˧˦
vót	v ɔ t̚ ˧˦
vô	v o ˧˧
vôi	v o j ˧˧
vôn	v o n ˧˧
võ	v ɔ ˦ˀ˥
võng	v a w ŋ͡m ˦ˀ˥
vù	v u ˨˩
vùi	v u j ˨˩
vùng	v ʊ w ŋ͡m ˨˩
vú	v u ˧˦
vút	v u t̚ ˧˦
văn	v a n ˧˧
văng	v a ŋ ˧˧
vĩ	v i ˦ˀ˥
vũ	v u ˦ˀ˥
vũng	v ʊ w ŋ͡m ˦ˀ˥
vơi	v əː j ˧˧
vưu	v i w ˧˧
vươn	v ɨ ə n ˧˧
vương	v ɨ ə ŋ ˧˧
vướng	v ɨ ə ŋ ˧˦
vườn	v ɨ ə n ˨˩
vượn	v ɨ ə n ˧˨ ʔ
vượng	v ɨ ə ŋ ˧˨ ʔ
vượt	v ɨ ə t̚ ˧˨ ʔ
vạ	v aː ˧˨ ʔ
vạc	v aː k̚ ˧˨ ʔ
vạch	v a j k̟̚ ˧˨ ʔ
vạn	v aː n ˧˨ ʔ
vạt	v aː t̚ ˧˨ ʔ
vả	v aː ˧˩
vải	v aː j ˧˩
vảy	v a j ˧˩
vấn	v ə n ˧˦
vấp	v ə p̚ ˧˦
vất	v ə t̚ ˧˦
vấy	v ə j ˧˦
vần	v ə n ˨˩
vầng	v ə ŋ ˨˩
vầy	v ə j ˨˩
vẫn	v ə n ˦ˀ˥
vẫy	v ə j ˦ˀ˥
vận	v ə n ˧˨ ʔ
vật	v ə t̚ ˧˨ ʔ
vậy	v ə j ˧˨ ʔ
vắng	v a ŋ ˧˦
vắt	v a t̚ ˧˦
vằn	v a n ˨˩
vặc	v a k̚ ˧˨ ʔ
vặn	v a n ˧˨ ʔ
vặt	v a t̚ ˧˨ ʔ
vẹm	v ɛ m ˧˨ ʔ
vẹn	v ɛ n ˧˨ ʔ
vẹo	v ɛ w ˧˨ ʔ
vẹt	v ɛ t̚ ˧˨ ʔ
vẻ	v ɛ ˧˩
vẽ	v ɛ ˦ˀ˥
vế	v e ˧˦
vết	v e t̚ ˧˦
vếu	v e w ˧˦
về	v e ˨˩
vểnh	v ə j ŋ̟ ˧˩
vệ	v e ˧˨ ʔ
vện	v e n ˧˨ ʔ
vệt	v e t̚ ˧˨ ʔ
vỉ	v i ˧˩
vỉa	v i ə ˧˩
vị	v i ˧˨ ʔ
vịn	v i n ˧˨ ʔ
vịnh	v ï ŋ ˧˨ ʔ
vịt	v i t̚ ˧˨ ʔ
vọc	v a w k͡p̚ ˧˨ ʔ
vọng	v a w ŋ͡m ˧˨ ʔ
vọt	v ɔ t̚ ˧˨ ʔ
vỏ	v ɔ ˧˩
vốc	v ə w k͡p̚ ˧˦
vốn	v o n ˧˦
vồ	v o ˨˩
vồng	v ə w ŋ͡m ˨˩
vỗ	v o ˦ˀ˥
vội	v o j ˧˨ ʔ
vớ	v əː ˧˦
với	v əː j ˧˦
vớt	v əː t̚ ˧˦
vờ	v əː ˨˩
vời	v əː j ˨˩
vờn	v əː n ˨˩
vở	v əː ˧˩
vỡ	v əː ˦ˀ˥
vợ	v əː ˧˨ ʔ
vợt	v əː t̚ ˧˨ ʔ
vụ	v u ˧˨ ʔ
vụn	v u n ˧˨ ʔ
vụng	v ʊ w ŋ͡m ˧˨ ʔ
vụt	v u t̚ ˧˨ ʔ
vứt	v ɨ t̚ ˧˦
vừa	v ɨ ə ˨˩
vừng	v ɨ ŋ ˨˩
vữa	v ɨ ə ˦ˀ˥
vững	v ɨ ŋ ˦ˀ˥
vựa	v ɨ ə ˧˨ ʔ
vực	v ɨ k̚ ˧˨ ʔ
x	ʔ i t̚ ˧˦ s i ˨˩
xa	s aː ˧˧
xanh	s a j ŋ̟ ˧˧
xaviê	s aː ˧˧ v i ˧˧ ʔ e ˧˧
xay	s a j ˧˧
xe	s ɛ ˧˧
xem	s ɛ m ˧˧
xen	s ɛ n ˧˧
xenon	s e ˧˧ n ə w ŋ͡m ˧˧
xeri	s ɛ ˧˧ ɹ i ˧˧
xesi	s e ˧˧ s i ˧˧
xin	s i n ˧˧
xinh	s ï ŋ ˧˧
xiêm	s i ə m ˧˧
xiên	s i ə n ˧˧
xiêu	s i ə w ˧˧
xiếc	s i ə k̚ ˧˦
xiềng	s i ə ŋ ˨˩
xoa	s w aː ˧˧
xoang	s w aː ŋ ˧˧
xoay	s w a j ˧˧
xoe	s w ɛ ˧˧
xoi	s ɔ j ˧˧
xong	s a w ŋ͡m ˧˧
xoong	s ɔ ŋ ˧˧
xoài	s w aː j ˨˩
xoàn	s w aː n ˨˩
xoá	s w aː ˧˦
xoáy	s w a j ˧˦
xoã	s w aː ˦ˀ˥
xoè	s w ɛ ˨˩
xoăn	s w a n ˧˧
xoạc	s w aː k̚ ˧˨ ʔ
xoắn	s w a n ˧˦
xtiêng	s t i ə ŋ ˧˧
xu	s u ˧˧
xua	s u ə ˧˧
xui	s u j ˧˧
xung	s ʊ w ŋ͡m ˧˧
xuyên	s w i ə n ˧˧
xuyến	s w i ə n ˧˦
xuân	s w ə n ˧˧
xuôi	s u ə j ˧˧
xuýt	s w i t̚ ˧˦
xuất	s w ə t̚ ˧˦
xuống	s u ə ŋ ˧˦
xuồng	s u ə ŋ ˨˩
xà	s aː ˨˩
xài	s aː j ˨˩
xàm	s aː m ˨˩
xào	s aː w ˨˩
xá	s aː ˧˦
xác	s aː k̚ ˧˦
xách	s a j k̟̚ ˧˦
xái	s aː j ˧˦
xám	s aː m ˧˦
xáo	s aː w ˧˦
xát	s aː t̚ ˧˦
xáy	s a j ˧˦
xâu	s ə w ˧˧
xây	s ə j ˧˧
xã	s aː ˦ˀ˥
xèng	s ɛ ŋ ˨˩
xèo	s ɛ w ˨˩
xé	s ɛ ˧˦
xém	s ɛ m ˧˦
xén	s ɛ n ˧˦
xéo	s ɛ w ˧˦
xét	s ɛ t̚ ˧˦
xê	s e ˧˧
xì	s i ˨˩
xí	s i ˧˦
xía	s i ə ˧˦
xích	s ï k̟̚ ˧˦
xíu	s i w ˧˦
xó	s ɔ ˧˦
xóc	s a w k͡p̚ ˧˦
xói	s ɔ j ˧˦
xóm	s ɔ m ˧˦
xót	s ɔ t̚ ˧˦
xô	s o ˧˧
xôi	s o j ˧˧
xông	s ə w ŋ͡m ˧˧
xù	s u ˨˩
xúc	s ʊ w k͡p̚ ˧˦
xúi	s u j ˧˦
xúm	s u m ˧˦
xúp	s u p̚ ˧˦
xút	s u t̚ ˧˦
xăm	s a m ˧˧
xăng	s a ŋ ˧˧
xơ	s əː ˧˧
xơi	s əː j ˧˧
xưa	s ɨ ə ˧˧
xưng	s ɨ ŋ ˧˧
xương	s ɨ ə ŋ ˧˧
xước	s ɨ ə k̚ ˧˦
xướng	s ɨ ə ŋ ˧˦
xưởng	s ɨ ə ŋ ˧˩
xạo	s aː w ˧˨ ʔ
xả	s aː ˧˩
xảo	s aː w ˧˩
xảy	s a j ˧˩
xấp	s ə p̚ ˧˦
xấu	s ə w ˧˦
xắn	s a n ˧˦
xắt	s a t̚ ˧˦
xẹp	s ɛ p̚ ˧˨ ʔ
xẻ	s ɛ ˧˩
xẻng	s ɛ ŋ ˧˩
xế	s e ˧˦
xếch	s ə j k̟̚ ˧˦
xếp	s e p̚ ˧˦
xệ	s e ˧˨ ʔ
xỉa	s i ə ˧˩
xỉn	s i n ˧˩
xỉu	s i w ˧˩
xị	s i ˧˨ ʔ
xịn	s i n ˧˨ ʔ
xịt	s i t̚ ˧˨ ʔ
xỏ	s ɔ ˧˩
xốc	s ə w k͡p̚ ˧˦
xối	s o j ˧˦
xốp	s o p̚ ˧˦
xốt	s o t̚ ˧˦
xới	s əː j ˧˦
xứ	s ɨ ˧˦
xức	s ɨ k̚ ˧˦
xử	s ɨ ˧˩
xực	s ɨ k̚ ˧˨ ʔ
y	ʔ i ˧˧
y	ʔ i ˧˧ z aː j ˨˩
ytecbi	ʔ i ˧˧ t ɛ k̚ ˧˦ ʔ ɓ i ˧˧
ytri	ʔ i ˧˧ t͡ɕ i ˧˧
yên	ʔ i ə n ˧˧
yêu	ʔ i ə w ˧˧
yếm	ʔ i ə m ˧˦
yến	ʔ i ə n ˧˦
yếu	ʔ i ə w ˧˦
yểm	ʔ i ə m ˧˩
yểu	ʔ i ə w ˧˩
ziriconi	z i ˧˧ ɹ i ˧˧ k ɔ ˧˧ n i ˧˧
à	ʔ aː ˨˩
ào	ʔ aː w ˨˩
á	ʔ aː ˧˦
ác	ʔ aː k̚ ˧˦
ách	ʔ a j k̟̚ ˧˦
ái	ʔ aː j ˧˦
ám	ʔ aː m ˧˦
án	ʔ aː n ˧˦
áng	ʔ aː ŋ ˧˦
ánh	ʔ a j ŋ̟ ˧˦
áo	ʔ aː w ˧˦
áp	ʔ aː p̚ ˧˦
át	ʔ aː t̚ ˧˦
â	ʔ əː ˧˦
âm	ʔ ə m ˧˧
ân	ʔ ə n ˧˧
âu	ʔ ə w ˧˧
éc	ʔ ɛ k̚ ˧˦
ém	ʔ ɛ m ˧˦
én	ʔ ɛ n ˧˦
éo	ʔ ɛ w ˧˦
ép	ʔ ɛ p̚ ˧˦
ét	ʔ ɛ t̚ ˧˦
ê	ʔ e ˧˧
êkip	ʔ e ˧˧ k i p̚ ˧˦
êm	ʔ e m ˧˧
êtanol	ʔ e ˧˧ t aː ˧˧ n ɔ n ˧˧
êugêniô	ʔ e w ˧˧ ɣ e n ˧˧ n i ˧˧ ʔ o ˧˧
ì	ʔ i ˨˩
ích	ʔ ï k̟̚ ˧˦
ít	ʔ i t̚ ˧˦
ítcariốt	ʔ i t̚ ˧˦ k aː ˧˧ ɹ i ˧˧ ʔ o t̚ ˧˦
ó	ʔ ɔ ˧˦
óc	ʔ a w k͡p̚ ˧˦
ói	ʔ ɔ j ˧˦
óng	ʔ a w ŋ͡m ˧˦
ót	ʔ ɔ t̚ ˧˦
ô	ʔ o ˧˧
ôbace	ʔ ə w ŋ͡m ˧˧ ʔ ɓ aː ˨˩ ʔ a j ŋ̟ ˧˧ t͡ɕ i ˧˨ ʔ ʔ ɛ m ˧˧
ôi	ʔ o j ˧˧
ôm	ʔ o m ˧˧
ôn	ʔ o n ˧˧
ông	ʔ ə w ŋ͡m ˧˧
ôzôn	ʔ o ˧˧ z o n ˧˧
ù	ʔ u ˨˩
ùn	ʔ u n ˨˩
ú	ʔ u ˧˦
úa	ʔ u ə ˧˦
úc	ʔ ʊ w k͡p̚ ˧˦
úi	ʔ u j ˧˦
úng	ʔ ʊ w ŋ͡m ˧˦
úp	ʔ u p̚ ˧˦
út	ʔ u t̚ ˧˦
ý	ʔ i ˧˦
ă	ʔ aː ˧˦
ăn	ʔ a n ˧˧
đ	ʔ ɗ e ˧˧
đa	ʔ ɗ aː ˧˧
đai	ʔ ɗ aː j ˧˧
đam	ʔ ɗ aː m ˧˧
đaminh	ʔ ɗ aː ˧˧ m ï ŋ ˧˧
đan	ʔ ɗ aː n ˧˧
đang	ʔ ɗ aː ŋ ˧˧
đanh	ʔ ɗ a j ŋ̟ ˧˧
đao	ʔ ɗ aː w ˧˧
đau	ʔ ɗ a w ˧˧
đay	ʔ ɗ a j ˧˧
đcg	ʔ ɗ ɨ k̚ ˧˦ t͡ɕ u ə ˧˦ z e ˧˧ s u ˧˧
đe	ʔ ɗ ɛ ˧˧
đem	ʔ ɗ ɛ m ˧˧
đen	ʔ ɗ ɛ n ˧˧
đeo	ʔ ɗ ɛ w ˧˧
đhy	ʔ ɗ ɨ k̚ ˧˦ h ə w ŋ͡m ˨˩ ʔ i ˧˧
đi	ʔ ɗ i ˧˧
đinh	ʔ ɗ ï ŋ ˧˧
điprozi	ʔ ɗ i p̚ ˧˧ ɹ ɔ ˧˧ z i ˧˧
điên	ʔ ɗ i ə n ˧˧
điêu	ʔ ɗ i ə w ˧˧
điônisiô	ʔ ɗ i ˧˧ ʔ o n ˧˧ n i ˧˧ s i ˧˧ ʔ o ˧˧
điếc	ʔ ɗ i ə k̚ ˧˦
điếm	ʔ ɗ i ə m ˧˦
điếu	ʔ ɗ i ə w ˧˦
điền	ʔ ɗ i ə n ˨˩
điều	ʔ ɗ i ə w ˨˩
điểm	ʔ ɗ i ə m ˧˩
điển	ʔ ɗ i ə n ˧˩
điện	ʔ ɗ i ə n ˧˨ ʔ
điệp	ʔ ɗ i ə p̚ ˧˨ ʔ
điệu	ʔ ɗ i ə w ˧˨ ʔ
đm	ʔ ɗ əː ˨˩ m əː ˨˩
đo	ʔ ɗ ɔ ˧˧
đoan	ʔ ɗ w aː n ˧˧
đong	ʔ ɗ a w ŋ͡m ˧˧
đoàn	ʔ ɗ w aː n ˨˩
đoá	ʔ ɗ w aː ˧˦
đoán	ʔ ɗ w aː n ˧˦
đoạn	ʔ ɗ w aː n ˧˨ ʔ
đoạt	ʔ ɗ w aː t̚ ˧˨ ʔ
đoản	ʔ ɗ w aː n ˧˩
đtdđ	ʔ ɗ i ə n ˧˨ ʔ tʰ w aː j ˧˨ ʔ z i ˧˧ ʔ ɗ ə w ŋ͡m ˧˨ ʔ
đu	ʔ ɗ u ˧˧
đua	ʔ ɗ u ə ˧˧
đui	ʔ ɗ u j ˧˧
đun	ʔ ɗ u n ˧˧
đupni	ʔ ɗ u p̚ ˧˦ n i ˧˧
đuôi	ʔ ɗ u ə j ˧˧
đuông	ʔ ɗ u ə ŋ ˧˧
đuốc	ʔ ɗ u ə k̚ ˧˦
đuối	ʔ ɗ u ə j ˧˦
đuổi	ʔ ɗ u ə j ˧˩
đà	ʔ ɗ aː ˨˩
đài	ʔ ɗ aː j ˨˩
đàm	ʔ ɗ aː m ˨˩
đàn	ʔ ɗ aː n ˨˩
đàng	ʔ ɗ aː ŋ ˨˩
đành	ʔ ɗ a j ŋ̟ ˨˩
đào	ʔ ɗ aː w ˨˩
đày	ʔ ɗ a j ˨˩
đá	ʔ ɗ aː ˧˦
đái	ʔ ɗ aː j ˧˦
đám	ʔ ɗ aː m ˧˦
đán	ʔ ɗ aː n ˧˦
đáng	ʔ ɗ aː ŋ ˧˦
đánh	ʔ ɗ a j ŋ̟ ˧˦
đáp	ʔ ɗ aː p̚ ˧˦
đát	ʔ ɗ aː t̚ ˧˦
đáy	ʔ ɗ a j ˧˦
đâm	ʔ ɗ ə m ˧˧
đâu	ʔ ɗ ə w ˧˧
đây	ʔ ɗ ə j ˧˧
đã	ʔ ɗ aː ˦ˀ˥
đãi	ʔ ɗ aː j ˦ˀ˥
đè	ʔ ɗ ɛ ˨˩
đèn	ʔ ɗ ɛ n ˨˩
đèo	ʔ ɗ ɛ w ˨˩
đéo	ʔ ɗ ɛ w ˧˦
đê	ʔ ɗ e ˧˧
đêm	ʔ ɗ e m ˧˧
đì	ʔ ɗ i ˨˩
đìa	ʔ ɗ i ə ˨˩
đình	ʔ ɗ ï ŋ ˨˩
đía	ʔ ɗ i ə ˧˦
đích	ʔ ɗ ï k̟̚ ˧˦
đính	ʔ ɗ ï ŋ ˧˦
đít	ʔ ɗ i t̚ ˧˦
đò	ʔ ɗ ɔ ˨˩
đòi	ʔ ɗ ɔ j ˨˩
đòm	ʔ ɗ ɔ m ˨˩
đòn	ʔ ɗ ɔ n ˨˩
đó	ʔ ɗ ɔ ˧˦
đói	ʔ ɗ ɔ j ˧˦
đón	ʔ ɗ ɔ n ˧˦
đóng	ʔ ɗ a w ŋ͡m ˧˦
đô	ʔ ɗ o ˧˧
đôi	ʔ ɗ o j ˧˧
đông	ʔ ɗ ə w ŋ͡m ˧˧
đù	ʔ ɗ u ˨˩
đùa	ʔ ɗ u ə ˨˩
đùi	ʔ ɗ u j ˨˩
đùm	ʔ ɗ u m ˨˩
đùng	ʔ ɗ ʊ w ŋ͡m ˨˩
đú	ʔ ɗ u ˧˦
đúc	ʔ ɗ ʊ w k͡p̚ ˧˦
đúng	ʔ ɗ ʊ w ŋ͡m ˧˦
đúp	ʔ ɗ u p̚ ˧˦
đút	ʔ ɗ u t̚ ˧˦
đăm	ʔ ɗ a m ˧˧
đăng	ʔ ɗ a ŋ ˧˧
đĩ	ʔ ɗ i ˦ˀ˥
đĩa	ʔ ɗ i ə ˦ˀ˥
đũa	ʔ ɗ u ə ˦ˀ˥
đũng	ʔ ɗ ʊ w ŋ͡m ˦ˀ˥
đũy	ʔ ɗ w i ˦ˀ˥
đơ	ʔ ɗ əː ˧˧
đơm	ʔ ɗ əː m ˧˧
đơn	ʔ ɗ əː n ˧˧
đưa	ʔ ɗ ɨ ə ˧˧
đương	ʔ ɗ ɨ ə ŋ ˧˧
đước	ʔ ɗ ɨ ə k̚ ˧˦
đường	ʔ ɗ ɨ ə ŋ ˨˩
được	ʔ ɗ ɨ ə k̚ ˧˨ ʔ
đượm	ʔ ɗ ɨ ə m ˧˨ ʔ
đạc	ʔ ɗ aː k̚ ˧˨ ʔ
đại	ʔ ɗ aː j ˧˨ ʔ
đạm	ʔ ɗ aː m ˧˨ ʔ
đạn	ʔ ɗ aː n ˧˨ ʔ
đạo	ʔ ɗ aː w ˧˨ ʔ
đạp	ʔ ɗ aː p̚ ˧˨ ʔ
đạt	ʔ ɗ aː t̚ ˧˨ ʔ
đả	ʔ ɗ aː ˧˩
đảm	ʔ ɗ aː m ˧˩
đảng	ʔ ɗ aː ŋ ˧˩
đảo	ʔ ɗ aː w ˧˩
đấm	ʔ ɗ ə m ˧˦
đấng	ʔ ɗ ə ŋ ˧˦
đất	ʔ ɗ ə t̚ ˧˦
đấu	ʔ ɗ ə w ˧˦
đấy	ʔ ɗ ə j ˧˦
đầm	ʔ ɗ ə m ˨˩
đần	ʔ ɗ ə n ˨˩
đầu	ʔ ɗ ə w ˨˩
đầy	ʔ ɗ ə j ˨˩
đẩu	ʔ ɗ ə w ˧˩
đẩy	ʔ ɗ ə j ˧˩
đẫm	ʔ ɗ ə m ˦ˀ˥
đẫy	ʔ ɗ ə j ˦ˀ˥
đậm	ʔ ɗ ə m ˧˨ ʔ
đập	ʔ ɗ ə p̚ ˧˨ ʔ
đậu	ʔ ɗ ə w ˧˨ ʔ
đậy	ʔ ɗ ə j ˧˨ ʔ
đắm	ʔ ɗ a m ˧˦
đắng	ʔ ɗ a ŋ ˧˦
đắp	ʔ ɗ a p̚ ˧˦
đắt	ʔ ɗ a t̚ ˧˦
đằm	ʔ ɗ a m ˨˩
đằng	ʔ ɗ a ŋ ˨˩
đẳng	ʔ ɗ a ŋ ˧˩
đặc	ʔ ɗ a k̚ ˧˨ ʔ
đặng	ʔ ɗ a ŋ ˧˨ ʔ
đặt	ʔ ɗ a t̚ ˧˨ ʔ
đẹp	ʔ ɗ ɛ p̚ ˧˨ ʔ
đẹt	ʔ ɗ ɛ t̚ ˧˨ ʔ
đẻ	ʔ ɗ ɛ ˧˩
đẻn	ʔ ɗ ɛ n ˧˩
đẽo	ʔ ɗ ɛ w ˦ˀ˥
đế	ʔ ɗ e ˧˦
đếch	ʔ ɗ ə j k̟̚ ˧˦
đếm	ʔ ɗ e m ˧˦
đến	ʔ ɗ e n ˧˦
đề	ʔ ɗ e ˨˩
đền	ʔ ɗ e n ˨˩
đều	ʔ ɗ e w ˨˩
để	ʔ ɗ e ˧˩
đểu	ʔ ɗ e w ˧˩
đệ	ʔ ɗ e ˧˨ ʔ
đệm	ʔ ɗ e m ˧˨ ʔ
đệt	ʔ ɗ e t̚ ˧˨ ʔ
đỉa	ʔ ɗ i ə ˧˩
đỉnh	ʔ ɗ ï ŋ ˧˩
địch	ʔ ɗ ï k̟̚ ˧˨ ʔ
định	ʔ ɗ ï ŋ ˧˨ ʔ
địt	ʔ ɗ i t̚ ˧˨ ʔ
đọ	ʔ ɗ ɔ ˧˨ ʔ
đọc	ʔ ɗ a w k͡p̚ ˧˨ ʔ
đọi	ʔ ɗ ɔ j ˧˨ ʔ
đọng	ʔ ɗ a w ŋ͡m ˧˨ ʔ
đọt	ʔ ɗ ɔ t̚ ˧˨ ʔ
đỏ	ʔ ɗ ɔ ˧˩
đỏm	ʔ ɗ ɔ m ˧˩
đố	ʔ ɗ o ˧˦
đốc	ʔ ɗ ə w k͡p̚ ˧˦
đối	ʔ ɗ o j ˧˦
đốm	ʔ ɗ o m ˧˦
đốn	ʔ ɗ o n ˧˦
đống	ʔ ɗ ə w ŋ͡m ˧˦
đốt	ʔ ɗ o t̚ ˧˦
đồ	ʔ ɗ o ˨˩
đồi	ʔ ɗ o j ˨˩
đồn	ʔ ɗ o n ˨˩
đồng	ʔ ɗ ə w ŋ͡m ˨˩
đổ	ʔ ɗ o ˧˩
đổi	ʔ ɗ o j ˧˩
đỗ	ʔ ɗ o ˦ˀ˥
đỗi	ʔ ɗ o j ˦ˀ˥
độ	ʔ ɗ o ˧˨ ʔ
độc	ʔ ɗ ə w k͡p̚ ˧˨ ʔ
đội	ʔ ɗ o j ˧˨ ʔ
độn	ʔ ɗ o n ˧˨ ʔ
động	ʔ ɗ ə w ŋ͡m ˧˨ ʔ
đột	ʔ ɗ o t̚ ˧˨ ʔ
đớ	ʔ ɗ əː ˧˦
đới	ʔ ɗ əː j ˧˦
đớn	ʔ ɗ əː n ˧˦
đớp	ʔ ɗ əː p̚ ˧˦
đờ	ʔ ɗ əː ˨˩
đời	ʔ ɗ əː j ˨˩
đờm	ʔ ɗ əː m ˨˩
đờn	ʔ ɗ əː n ˨˩
đỡ	ʔ ɗ əː ˦ˀ˥
đợi	ʔ ɗ əː j ˧˨ ʔ
đợt	ʔ ɗ əː t̚ ˧˨ ʔ
đụ	ʔ ɗ u ˧˨ ʔ
đục	ʔ ɗ ʊ w k͡p̚ ˧˨ ʔ
đụn	ʔ ɗ u n ˧˨ ʔ
đụng	ʔ ɗ ʊ w ŋ͡m ˧˨ ʔ
đụt	ʔ ɗ u t̚ ˧˨ ʔ
đủ	ʔ ɗ u ˧˩
đứa	ʔ ɗ ɨ ə ˧˦
đức	ʔ ɗ ɨ k̚ ˧˦
đứng	ʔ ɗ ɨ ŋ ˧˦
đứt	ʔ ɗ ɨ t̚ ˧˦
đừng	ʔ ɗ ɨ ŋ ˨˩
đực	ʔ ɗ ɨ k̚ ˧˨ ʔ
đựng	ʔ ɗ ɨ ŋ ˧˨ ʔ
ơ	ʔ əː ˧˧
ơi	ʔ əː j ˧˧
ơn	ʔ əː n ˧˧
ư	ʔ ɨ ˧˧
ưa	ʔ ɨ ə ˧˧
ưng	ʔ ɨ ŋ ˧˧
ươi	ʔ ɨ ə j ˧˧
ươn	ʔ ɨ ə n ˧˧
ước	ʔ ɨ ə k̚ ˧˦
ướp	ʔ ɨ ə p̚ ˧˦
ướt	ʔ ɨ ə t̚ ˧˦
ạ	ʔ aː ˧˨ ʔ
ả	ʔ aː ˧˩
ải	ʔ aː j ˧˩
ảnh	ʔ a j ŋ̟ ˧˩
ảo	ʔ aː w ˧˩
ấm	ʔ ə m ˧˦
ấn	ʔ ə n ˧˦
ấp	ʔ ə p̚ ˧˦
ất	ʔ ə t̚ ˧˦
ấu	ʔ ə w ˧˦
ấy	ʔ ə j ˧˦
ầm	ʔ ə m ˨˩
ẩm	ʔ ə m ˧˩
ẩn	ʔ ə n ˧˩
ẩu	ʔ ə w ˧˩
ập	ʔ ə p̚ ˧˨ ʔ
ắp	ʔ a p̚ ˧˦
ắt	ʔ a t̚ ˧˦
ẳng	ʔ a ŋ ˧˩
ẵm	ʔ a m ˦ˀ˥
ẹ	ʔ ɛ ˧˨ ʔ
ẹp	ʔ ɛ p̚ ˧˨ ʔ
ẻm	ʔ ɛ m ˧˩
ế	ʔ e ˧˦
ếch	ʔ ə j k̟̚ ˧˦
ềnh	ʔ ə j ŋ̟ ˨˩
ễnh	ʔ ə j ŋ̟ ˦ˀ˥
ỉa	ʔ i ə ˧˩
ỉm	ʔ i m ˧˩
ỉn	ʔ i n ˧˩
ỉu	ʔ i w ˧˩
ị	ʔ i ˧˨ ʔ
ịch	ʔ ï k̟̚ ˧˨ ʔ
ịn	ʔ i n ˧˨ ʔ
ịt	ʔ i t̚ ˧˨ ʔ
ọe	ʔ w ɛ ˧˨ ʔ
ốc	ʔ ə w k͡p̚ ˧˦
ối	ʔ o j ˧˦
ốm	ʔ o m ˧˦
ống	ʔ ə w ŋ͡m ˧˦
ốp	ʔ o p̚ ˧˦
ồ	ʔ o ˨˩
ồn	ʔ o n ˨˩
ổ	ʔ o ˧˩
ổi	ʔ o j ˧˩
ổn	ʔ o n ˧˩
ổng	ʔ ə w ŋ͡m ˧˩
ộp	ʔ o p̚ ˧˨ ʔ
ớ	ʔ əː ˧˦
ớn	ʔ əː n ˧˦
ớt	ʔ əː t̚ ˧˦
ờ	ʔ əː ˨˩
ở	ʔ əː ˧˩
ợ	ʔ əː ˧˨ ʔ
ụ	ʔ u ˧˨ ʔ
ủ	ʔ u ˧˩
ủa	ʔ u ə ˧˩
ủi	ʔ u j ˧˩
ủng	ʔ ʊ w ŋ͡m ˧˩
ứ	ʔ ɨ ˧˦
ứa	ʔ ɨ ə ˧˦
ức	ʔ ɨ k̚ ˧˦
ứng	ʔ ɨ ŋ ˧˦
ừ	ʔ ɨ ˨˩
ừa	ʔ ɨ ə ˨˩
ừm	ʔ ɨ m ˨˩
ửng	ʔ ɨ ŋ ˧˩
ực	ʔ ɨ k̚ ˧˨ ʔ
