ace	ʔ a n ˧˧ c ɪ j ˨˩˨ ʔ ɛ m ˧˧
actini	ʔ aː k̚ ˦˥ t ɪ j ˧˧ n ɪ j ˧˧
adn	ʔ aː ˧˧ ʔ ɗ e j ˧˧ ʔ ɛ ŋ ˧˧
agon	ʔ aː ˧˧ ɣ ə w ŋ͡m ˧˧
ai	ʔ aː j ˧˧
alexanđê	ʔ aː ˧˧ l ɛ k̚ ˦˥ s aː ŋ ˧˧ ʔ ɗ e j ˧˧
am	ʔ aː m ˧˧
ambrôsiô	ʔ aː m ˧˧ ʔ ɓ ɹ o w ˧˧ s ɪ j ˧˧ ʔ o w ˧˧
amerixi	ʔ aː ˧˧ m e j ˧˧ ɹ ɪ j ˧˧ s ɪ j ˧˧
amoni	ʔ aː ˧˧ m o w ˧˧ n ɪ j ˧˧
an	ʔ aː ŋ ˧˧
ancol	ʔ aː n ˧˧ k o n ˧˧
ang	ʔ aː ŋ ˧˧
anh	ʔ a n ˧˧
anphongsô	ʔ aː ŋ ˧˧ f a w ŋ͡m ˧˧ ʂ o w ˧˧
anphonsô	ʔ aː ŋ ˧˧ f ɔ ŋ ˧˧ ʂ o w ˧˧
anrê	ʔ aː ŋ ˧˧ ɹ e j ˧˧
antimon	ʔ aː ŋ ˧˧ t ɪ j ˧˧ m ɔ ŋ ˧˧
antôn	ʔ aː ŋ ˧˧ t o ŋ ˧˧
anê	ʔ aː ŋ ˧˧ n e j ˧˧
ao	ʔ aː w ˧˧
asen	ʔ aː ˧˧ s ɛ n ˧˧
atatin	ʔ aː ˧˧ t aː ˧˧ t ɨ n ˧˧
au	ʔ aː w ˧˧
augustinô	ʔ aː w ˧˧ ɣ ʊ w ˧˧ s t ɨ n ˧˧ n o w ˧˧
axit	ʔ aː ˧˧ s ɨ t̚ ˦˥
axít	ʔ aː ˧˧ s ɨ t̚ ˦˥
b	ʔ ɓ e j ˧˧
ba	ʔ ɓ aː ˧˧
ban	ʔ ɓ aː ŋ ˧˧
bang	ʔ ɓ aː ŋ ˧˧
banh	ʔ ɓ a n ˧˧
bao	ʔ ɓ aː w ˧˧
bari	ʔ ɓ aː ˧˧ ɹ ɪ j ˧˧
batôlômêô	ʔ ɓ aː ˧˧ t o w ˧˧ l o w ˧˧ m e j ˧˧ ʔ o w ˧˧
bay	ʔ ɓ aː j ˧˧
bazơ	ʔ ɓ aː ˧˧ z əː ˧˧
be	ʔ ɓ ɛ ˧˧
beckeli	ʔ ɓ ɛ k̚ ˦˥ k e j ˧˧ l ɪ j ˧˧
beo	ʔ ɓ ɛ w ˧˧
beri	ʔ ɓ ɛ ˧˧ ɹ ɪ j ˧˧
berili	ʔ ɓ ɛ ˧˧ ɹ ɪ j ˧˧ l ɪ j ˧˧
bi	ʔ ɓ ɪ j ˧˧
bia	ʔ ɓ i ə ˧˧
binh	ʔ ɓ ɨ n ˧˧
bismut	ʔ ɓ ɨ t̚ ˧˧ m ʊ k͡p̚ ˧˧
bit	ʔ ɓ ɨ t̚ ˧˧
bitmut	ʔ ɓ ɨ t̚ ˧˧ m ʊ k͡p̚ ˧˧
biên	ʔ ɓ i ə ŋ ˧˧
biếc	ʔ ɓ i ə k̚ ˦˥
biến	ʔ ɓ i ə ŋ ˦˥
biếng	ʔ ɓ i ə ŋ ˦˥
biết	ʔ ɓ i ə k̚ ˦˥
biếu	ʔ ɓ i w ˦˥
biền	ʔ ɓ i ə ŋ ˨˩
biển	ʔ ɓ i ə ŋ ˨˩˦
biểu	ʔ ɓ i w ˨˩˦
biện	ʔ ɓ i ə ŋ ˨˩˨
biệt	ʔ ɓ i ə k̚ ˨˩˨
blu	ʔ ɓ l ʊ w ˧˧
bo	ʔ ɓ ɔ ˧˧
boa	ʔ ɓ w aː ˧˧
bom	ʔ ɓ ɔ m ˧˧
bon	ʔ ɓ ɔ ŋ ˧˧
bong	ʔ ɓ a w ŋ͡m ˧˧
boong	ʔ ɓ ɔ ŋ ˧˧
brigitta	ʔ ɓ ɹ ɪ j ˧˧ j ɨ t̚ ˦˥ t aː ˧˧
brom	ʔ ɓ ɹ o m ˧˧
brâu	ʔ ɓ ɹ ə w ˧˧
bu	ʔ ɓ ʊ w ˧˧
bung	ʔ ɓ ʊ w ŋ͡m ˧˧
buôn	ʔ ɓ u ə ŋ ˧˧
buông	ʔ ɓ u ə ŋ ˧˧
buýt	ʔ ɓ w ɨ t̚ ˦˥
buốt	ʔ ɓ u ə k̚ ˦˥
buồi	ʔ ɓ u j ˨˩
buồm	ʔ ɓ u ə m ˨˩
buồn	ʔ ɓ u ə ŋ ˨˩
buồng	ʔ ɓ u ə ŋ ˨˩
buổi	ʔ ɓ u j ˨˩˦
buộc	ʔ ɓ u ə k̚ ˨˩˨
buột	ʔ ɓ u ə k̚ ˨˩˨
bà	ʔ ɓ aː ˨˩
bài	ʔ ɓ aː j ˨˩
bàn	ʔ ɓ aː ŋ ˨˩
bàng	ʔ ɓ aː ŋ ˨˩
bành	ʔ ɓ a n ˨˩
bào	ʔ ɓ aː w ˨˩
bàu	ʔ ɓ aː w ˨˩
bày	ʔ ɓ aː j ˨˩
bá	ʔ ɓ aː ˦˥
bác	ʔ ɓ aː k̚ ˦˥
bách	ʔ ɓ a t̚ ˦˥
bám	ʔ ɓ aː m ˦˥
bán	ʔ ɓ aː ŋ ˦˥
báng	ʔ ɓ aː ŋ ˦˥
bánh	ʔ ɓ a n ˦˥
báo	ʔ ɓ aː w ˦˥
bát	ʔ ɓ aː k̚ ˦˥
báu	ʔ ɓ aː w ˦˥
bâu	ʔ ɓ ə w ˧˧
bây	ʔ ɓ ə j ˧˧
bã	ʔ ɓ aː ˨˩˦
bãi	ʔ ɓ aː j ˨˩˦
bão	ʔ ɓ aː w ˨˩˦
bè	ʔ ɓ ɛ ˨˩
bèn	ʔ ɓ ɛ ŋ ˨˩
bèo	ʔ ɓ ɛ w ˨˩
bé	ʔ ɓ ɛ ˦˥
bén	ʔ ɓ ɛ ŋ ˦˥
béo	ʔ ɓ ɛ w ˦˥
bét	ʔ ɓ ɛ k̚ ˦˥
bê	ʔ ɓ e j ˧˧
bên	ʔ ɓ əː n ˧˧
bênađô	ʔ ɓ e j ˧˧ n aː ˧˧ ʔ ɗ o w ˧˧
bênh	ʔ ɓ əː n ˧˧
bênêđictô	ʔ ɓ e j ˧˧ n e j ˧˧ ʔ ɗ ɨ t̚ ˦˥ t o w ˧˧
bêu	ʔ ɓ e w ˧˧
bì	ʔ ɓ ɪ j ˨˩
bìa	ʔ ɓ i ə ˨˩
bình	ʔ ɓ ɨ n ˨˩
bìu	ʔ ɓ i w ˨˩
bí	ʔ ɓ ɪ j ˦˥
bích	ʔ ɓ ɨ t̚ ˦˥
bím	ʔ ɓ i m ˦˥
bính	ʔ ɓ ɨ n ˦˥
bíp	ʔ ɓ i p̚ ˦˥
bít	ʔ ɓ ɨ t̚ ˦˥
bíu	ʔ ɓ i w ˦˥
bò	ʔ ɓ ɔ ˨˩
bòn	ʔ ɓ ɔ ŋ ˨˩
bó	ʔ ɓ ɔ ˦˥
bóc	ʔ ɓ a w k͡p̚ ˦˥
bói	ʔ ɓ ɔ j ˦˥
bón	ʔ ɓ ɔ ŋ ˦˥
bóng	ʔ ɓ a w ŋ͡m ˦˥
bóp	ʔ ɓ ɔ p̚ ˦˥
bót	ʔ ɓ ɔ k̚ ˦˥
bô	ʔ ɓ o w ˧˧
bôi	ʔ ɓ o j ˧˧
bôm	ʔ ɓ o m ˧˧
bông	ʔ ɓ ə w ŋ͡m ˧˧
bônifaciô	ʔ ɓ o ŋ ˧˧ n ɪ j ˧˧ f aː ˧˧ s ɪ j ˧˧ ʔ o w ˧˧
bõ	ʔ ɓ ɔ ˨˩˦
bù	ʔ ɓ ʊ w ˨˩
bùa	ʔ ɓ u ə ˨˩
bùi	ʔ ɓ u j ˨˩
bùm	ʔ ɓ ʊ m ˨˩
bùn	ʔ ɓ ʊ w ŋ͡m ˨˩
bùng	ʔ ɓ ʊ w ŋ͡m ˨˩
bú	ʔ ɓ ʊ w ˦˥
búa	ʔ ɓ u ə ˦˥
búi	ʔ ɓ u j ˦˥
bún	ʔ ɓ ʊ w ŋ͡m ˦˥
búng	ʔ ɓ ʊ w ŋ͡m ˦˥
búp	ʔ ɓ ʊ p̚ ˦˥
bút	ʔ ɓ ʊ k͡p̚ ˦˥
băm	ʔ ɓ a m ˧˧
băng	ʔ ɓ a ŋ ˧˧
bĩ	ʔ ɓ ɪ j ˨˩˦
bĩu	ʔ ɓ i w ˨˩˦
bơ	ʔ ɓ əː ˧˧
bơi	ʔ ɓ əː j ˧˧
bơm	ʔ ɓ əː m ˧˧
bư	ʔ ɓ ɨ ˧˧
bưng	ʔ ɓ ɨ ŋ ˧˧
bưu	ʔ ɓ ɨ w ˧˧
bươi	ʔ ɓ ɨ j ˧˧
bươu	ʔ ɓ ɨ ə w ˧˧
bước	ʔ ɓ ɨ ə k̚ ˦˥
bướm	ʔ ɓ ɨ ə m ˦˥
bướng	ʔ ɓ ɨ ə ŋ ˦˥
bướu	ʔ ɓ ɨ ə w ˦˥
bưởi	ʔ ɓ ɨ j ˨˩˦
bạ	ʔ ɓ aː ˨˩˨
bạc	ʔ ɓ aː k̚ ˨˩˨
bạch	ʔ ɓ a t̚ ˨˩˨
bại	ʔ ɓ aː j ˨˩˨
bạn	ʔ ɓ aː ŋ ˨˩˨
bạo	ʔ ɓ aː w ˨˩˨
bạt	ʔ ɓ aː k̚ ˨˩˨
bả	ʔ ɓ aː ˨˩˦
bản	ʔ ɓ aː ŋ ˨˩˦
bảng	ʔ ɓ aː ŋ ˨˩˦
bảo	ʔ ɓ aː w ˨˩˦
bảy	ʔ ɓ aː j ˨˩˦
bấm	ʔ ɓ ə m ˦˥
bất	ʔ ɓ ə k̚ ˦˥
bấu	ʔ ɓ ə w ˦˥
bấy	ʔ ɓ ə j ˦˥
bầm	ʔ ɓ ə m ˨˩
bần	ʔ ɓ ə ŋ ˨˩
bầu	ʔ ɓ ə w ˨˩
bầy	ʔ ɓ ə j ˨˩
bẩm	ʔ ɓ ə m ˨˩˦
bẩn	ʔ ɓ ə ŋ ˨˩˦
bẩy	ʔ ɓ ə j ˨˩˦
bẫy	ʔ ɓ ə j ˨˩˦
bậc	ʔ ɓ ə k̚ ˨˩˨
bận	ʔ ɓ ə ŋ ˨˩˨
bật	ʔ ɓ ə k̚ ˨˩˨
bậu	ʔ ɓ ə w ˨˩˨
bậy	ʔ ɓ ə j ˨˩˨
bắc	ʔ ɓ a k̚ ˦˥
bắn	ʔ ɓ a ŋ ˦˥
bắp	ʔ ɓ a p̚ ˦˥
bắt	ʔ ɓ a k̚ ˦˥
bằm	ʔ ɓ a m ˨˩
bằng	ʔ ɓ a ŋ ˨˩
bẹ	ʔ ɓ ɛ ˨˩˨
bẹn	ʔ ɓ ɛ ŋ ˨˩˨
bẹo	ʔ ɓ ɛ w ˨˩˨
bẹp	ʔ ɓ ɛ p̚ ˨˩˨
bẹt	ʔ ɓ ɛ k̚ ˨˩˨
bẻ	ʔ ɓ ɛ ˨˩˦
bế	ʔ ɓ e j ˦˥
bến	ʔ ɓ əː n ˦˥
bếp	ʔ ɓ e p̚ ˦˥
bết	ʔ ɓ əː t̚ ˦˥
bề	ʔ ɓ e j ˨˩
bền	ʔ ɓ əː n ˨˩
bể	ʔ ɓ e j ˨˩˦
bển	ʔ ɓ əː n ˨˩˦
bệ	ʔ ɓ e j ˨˩˨
bệch	ʔ ɓ əː t̚ ˨˩˨
bện	ʔ ɓ əː n ˨˩˨
bệnh	ʔ ɓ əː n ˨˩˨
bệt	ʔ ɓ əː t̚ ˨˩˨
bỉ	ʔ ɓ ɪ j ˨˩˦
bỉm	ʔ ɓ i m ˨˩˦
bị	ʔ ɓ ɪ j ˨˩˨
bịa	ʔ ɓ i ə ˨˩˨
bịch	ʔ ɓ ɨ t̚ ˨˩˨
bịnh	ʔ ɓ ɨ n ˨˩˨
bịp	ʔ ɓ i p̚ ˨˩˨
bịt	ʔ ɓ ɨ t̚ ˨˩˨
bọ	ʔ ɓ ɔ ˨˩˨
bọc	ʔ ɓ a w k͡p̚ ˨˩˨
bọn	ʔ ɓ ɔ ŋ ˨˩˨
bọng	ʔ ɓ a w ŋ͡m ˨˩˨
bọt	ʔ ɓ ɔ k̚ ˨˩˨
bỏ	ʔ ɓ ɔ ˨˩˦
bỏng	ʔ ɓ a w ŋ͡m ˨˩˦
bố	ʔ ɓ o w ˦˥
bốc	ʔ ɓ ə w k͡p̚ ˦˥
bốn	ʔ ɓ o ŋ ˦˥
bống	ʔ ɓ ə w ŋ͡m ˦˥
bốp	ʔ ɓ o p̚ ˦˥
bốt	ʔ ɓ o k̚ ˦˥
bồ	ʔ ɓ o w ˨˩
bồi	ʔ ɓ o j ˨˩
bồn	ʔ ɓ o ŋ ˨˩
bồng	ʔ ɓ ə w ŋ͡m ˨˩
bổ	ʔ ɓ o w ˨˩˦
bổi	ʔ ɓ o j ˨˩˦
bổn	ʔ ɓ o ŋ ˨˩˦
bổng	ʔ ɓ ə w ŋ͡m ˨˩˦
bỗng	ʔ ɓ ə w ŋ͡m ˨˩˦
bộ	ʔ ɓ o w ˨˩˨
bội	ʔ ɓ o j ˨˩˨
bộng	ʔ ɓ ə w ŋ͡m ˨˩˨
bột	ʔ ɓ o k̚ ˨˩˨
bớ	ʔ ɓ əː ˦˥
bới	ʔ ɓ əː j ˦˥
bớp	ʔ ɓ əː p̚ ˦˥
bớt	ʔ ɓ əː k̚ ˦˥
bờ	ʔ ɓ əː ˨˩
bờm	ʔ ɓ əː m ˨˩
bở	ʔ ɓ əː ˨˩˦
bởi	ʔ ɓ əː j ˨˩˦
bỡn	ʔ ɓ əː ŋ ˨˩˦
bợm	ʔ ɓ əː m ˨˩˨
bụi	ʔ ɓ u j ˨˩˨
bụm	ʔ ɓ ʊ m ˨˩˨
bụng	ʔ ɓ ʊ w ŋ͡m ˨˩˨
bụt	ʔ ɓ ʊ k͡p̚ ˨˩˨
bủa	ʔ ɓ u ə ˨˩˦
bứa	ʔ ɓ ɨ ə ˦˥
bức	ʔ ɓ ɨ k̚ ˦˥
bứng	ʔ ɓ ɨ ŋ ˦˥
bứt	ʔ ɓ ɨ k̚ ˦˥
bừa	ʔ ɓ ɨ ə ˨˩
bừng	ʔ ɓ ɨ ŋ ˨˩
bửa	ʔ ɓ ɨ ə ˨˩˦
bữa	ʔ ɓ ɨ ə ˨˩˦
bự	ʔ ɓ ɨ ˨˩˨
bựa	ʔ ɓ ɨ ə ˨˩˨
bực	ʔ ɓ ɨ k̚ ˨˩˨
c	s e j ˧˧
ca	k aː ˧˧
cacbon	k aː k̚ ˦˥ ʔ ɓ ɔ ŋ ˧˧
cai	k aː j ˧˧
califoni	k aː ˧˧ l ɪ j ˧˧ f ɔ ˧˧ n ɪ j ˧˧
cam	k aː m ˧˧
can	k aː ŋ ˧˧
canh	k a n ˧˧
canxi	k aː n ˧˧ s ɪ j ˧˧
cao	k aː w ˧˧
catarina	k aː ˧˧ t aː ˧˧ ɹ ɨ n ˧˧ n aː ˧˧
cau	k aː w ˧˧
cay	k aː j ˧˧
cađimi	k aː ˧˧ ʔ ɗ ɪ j ˧˧ m ɪ j ˧˧
ch	s e j ˧˧ h aː k̚ ˦˥
cha	c aː ˧˧
chai	c aː j ˧˧
chanh	c a n ˧˧
chao	c aː w ˧˧
chau	c aː w ˧˧
chay	c aː j ˧˧
che	c ɛ ˧˧
chen	c ɛ ŋ ˧˧
cheo	c ɛ w ˧˧
chi	c ɪ j ˧˧
chia	c i ə ˧˧
chim	c i m ˧˧
chinh	c ɨ n ˧˧
chiêm	c i m ˧˧
chiên	c i ə ŋ ˧˧
chiêng	c i ə ŋ ˧˧
chiêu	c i w ˧˧
chiếc	c i ə k̚ ˦˥
chiếm	c i m ˦˥
chiến	c i ə ŋ ˦˥
chiếp	c i p̚ ˦˥
chiếu	c i w ˦˥
chiền	c i ə ŋ ˨˩
chiều	c i w ˨˩
cho	c ɔ ˧˧
choa	c ⁽ʷ ⁾ aː ˧˧
choáng	c ⁽ʷ ⁾ aː ŋ ˦˥
choãi	c ⁽ʷ ⁾ aː j ˨˩˦
choét	c ⁽ʷ ⁾ ɛ k̚ ˦˥
choắt	c ⁽ʷ ⁾ a k̚ ˦˥
chu	c ʊ w ˧˧
chua	c u ə ˧˧
chui	c u j ˧˧
chum	c ʊ m ˧˧
chung	c ʊ w ŋ͡m ˧˧
chuyên	c ⁽ʷ ⁾ i ə ŋ ˧˧
chuyến	c ⁽ʷ ⁾ i ə ŋ ˦˥
chuyền	c ⁽ʷ ⁾ i ə ŋ ˨˩
chuyển	c ⁽ʷ ⁾ i ə ŋ ˨˩˦
chuyện	c ⁽ʷ ⁾ i ə ŋ ˨˩˨
chuông	c u ə ŋ ˧˧
chuẩn	c ⁽ʷ ⁾ ə ŋ ˨˩˦
chuốc	c u ə k̚ ˦˥
chuối	c u j ˦˥
chuốt	c u ə k̚ ˦˥
chuồn	c u ə ŋ ˨˩
chuồng	c u ə ŋ ˨˩
chuỗi	c u j ˨˩˦
chuộc	c u ə k̚ ˨˩˨
chuộng	c u ə ŋ ˨˩˨
chuột	c u ə k̚ ˨˩˨
chuỳ	c ⁽ʷ ⁾ ɪ j ˨˩
chxhcnvn	k ə w ŋ͡m ˨˩˨ w aː ˨˩ s aː ˨˩˦ h o j ˨˩˨ c ʊ w ˨˩˦ ŋ i ə ˨˩˦ v i ə k̚ ˨˩˨ n aː m ˧˧
chà	c aː ˨˩
chài	c aː j ˨˩
chàm	c aː m ˨˩
chàng	c aː ŋ ˨˩
chào	c aː w ˨˩
chày	c aː j ˨˩
chác	c aː k̚ ˦˥
chái	c aː j ˦˥
chán	c aː ŋ ˦˥
chánh	c a n ˦˥
cháo	c aː w ˦˥
chát	c aː k̚ ˦˥
cháu	c aː w ˦˥
cháy	c aː j ˦˥
châm	c ə m ˧˧
chân	c ə ŋ ˧˧
châu	c ə w ˧˧
chão	c aː w ˨˩˦
chè	c ɛ ˨˩
chèn	c ɛ ŋ ˨˩
chèo	c ɛ w ˨˩
ché	c ɛ ˦˥
chém	c ɛ m ˦˥
chén	c ɛ ŋ ˦˥
chéo	c ɛ w ˦˥
chép	c ɛ p̚ ˦˥
chê	c e j ˧˧
chêm	c e m ˧˧
chênh	c əː n ˧˧
chì	c ɪ j ˨˩
chìa	c i ə ˨˩
chìm	c i m ˨˩
chí	c ɪ j ˦˥
chích	c ɨ t̚ ˦˥
chín	c ɨ n ˦˥
chính	c ɨ n ˦˥
chíp	c i p̚ ˦˥
chít	c ɨ t̚ ˦˥
chòi	c ɔ j ˨˩
chòm	c ɔ m ˨˩
chó	c ɔ ˦˥
chói	c ɔ j ˦˥
chóng	c a w ŋ͡m ˦˥
chóp	c ɔ p̚ ˦˥
chót	c ɔ k̚ ˦˥
chôm	c o m ˧˧
chôn	c o ŋ ˧˧
chông	c ə w ŋ͡m ˧˧
chõ	c ɔ ˨˩˦
chùa	c u ə ˨˩
chùi	c u j ˨˩
chùm	c ʊ m ˨˩
chùn	c ʊ w ŋ͡m ˨˩
chú	c ʊ w ˦˥
chúa	c u ə ˦˥
chúc	c ʊ w k͡p̚ ˦˥
chúi	c u j ˦˥
chúng	c ʊ w ŋ͡m ˦˥
chút	c ʊ k͡p̚ ˦˥
chăm	c a m ˧˧
chăn	c a ŋ ˧˧
chăng	c a ŋ ˧˧
chĩa	c i ə ˨˩˦
chơi	c əː j ˧˧
chưa	c ɨ ə ˧˧
chưng	c ɨ ŋ ˧˧
chương	c ɨ ə ŋ ˧˧
chước	c ɨ ə k̚ ˦˥
chướng	c ɨ ə ŋ ˦˥
chưởng	c ɨ ə ŋ ˨˩˦
chạc	c aː k̚ ˨˩˨
chạm	c aː m ˨˩˨
chạng	c aː ŋ ˨˩˨
chạnh	c a n ˨˩˨
chạo	c aː w ˨˩˨
chạp	c aː p̚ ˨˩˨
chạy	c aː j ˨˩˨
chả	c aː ˨˩˦
chải	c aː j ˨˩˦
chảnh	c a n ˨˩˦
chảo	c aː w ˨˩˦
chảy	c aː j ˨˩˦
chấm	c ə m ˦˥
chấn	c ə ŋ ˦˥
chấp	c ə p̚ ˦˥
chất	c ə k̚ ˦˥
chấy	c ə j ˦˥
chầu	c ə w ˨˩
chậc	c ə k̚ ˨˩˨
chậm	c ə m ˨˩˨
chập	c ə p̚ ˨˩˨
chật	c ə k̚ ˨˩˨
chậu	c ə w ˨˩˨
chắc	c a k̚ ˦˥
chắn	c a ŋ ˦˥
chắp	c a p̚ ˦˥
chắt	c a k̚ ˦˥
chằn	c a ŋ ˨˩
chằng	c a ŋ ˨˩
chẳng	c a ŋ ˨˩˦
chẵn	c a ŋ ˨˩˦
chặc	c a k̚ ˨˩˨
chặn	c a ŋ ˨˩˨
chặng	c a ŋ ˨˩˨
chặt	c a k̚ ˨˩˨
chẹt	c ɛ k̚ ˨˩˨
chẻ	c ɛ ˨˩˦
chẽn	c ɛ ŋ ˨˩˦
chế	c e j ˦˥
chết	c əː t̚ ˦˥
chệch	c əː t̚ ˨˩˨
chỉ	c ɪ j ˨˩˦
chỉnh	c ɨ n ˨˩˦
chị	c ɪ j ˨˩˨
chịch	c ɨ t̚ ˨˩˨
chịu	c i w ˨˩˨
chọc	c a w k͡p̚ ˨˩˨
chọi	c ɔ j ˨˩˨
chọn	c ɔ ŋ ˨˩˨
chọt	c ɔ k̚ ˨˩˨
chỏm	c ɔ m ˨˩˦
chốc	c ə w k͡p̚ ˦˥
chối	c o j ˦˥
chốn	c o ŋ ˦˥
chống	c ə w ŋ͡m ˦˥
chốt	c o k̚ ˦˥
chồi	c o j ˨˩
chồm	c o m ˨˩
chồn	c o ŋ ˨˩
chồng	c ə w ŋ͡m ˨˩
chổi	c o j ˨˩˦
chỗ	c o w ˨˩˦
chộ	c o w ˨˩˨
chộp	c o p̚ ˨˩˨
chột	c o k̚ ˨˩˨
chớ	c əː ˦˥
chớm	c əː m ˦˥
chớp	c əː p̚ ˦˥
chờ	c əː ˨˩
chở	c əː ˨˩˦
chợ	c əː ˨˩˨
chợp	c əː p̚ ˨˩˨
chợt	c əː k̚ ˨˩˨
chục	c ʊ w k͡p̚ ˨˩˨
chụm	c ʊ m ˨˩˨
chụp	c ʊ p̚ ˨˩˨
chụt	c ʊ k͡p̚ ˨˩˨
chủ	c ʊ w ˨˩˦
chủng	c ʊ w ŋ͡m ˨˩˦
chứ	c ɨ ˦˥
chứa	c ɨ ə ˦˥
chức	c ɨ k̚ ˦˥
chứng	c ɨ ŋ ˦˥
chứt	c ɨ k̚ ˦˥
chừ	c ɨ ˨˩
chừa	c ɨ ə ˨˩
chừng	c ɨ ŋ ˨˩
chử	c ɨ ˨˩˦
chửa	c ɨ ə ˨˩˦
chửi	c ɨ j ˨˩˦
chữ	c ɨ ˨˩˦
chữa	c ɨ ə ˨˩˦
chực	c ɨ k̚ ˨˩˨
clb	k ə w ˧˧ l aː k̚ ˨˩˨ ʔ ɓ o w ˨˩˨
clo	k l ɔ ˧˧
clêmêntê	k l e j ˧˧ m əː n ˧˧ t e j ˧˧
co	k ɔ ˧˧
coban	k o w ˧˧ ʔ ɓ aː n ˧˧
cocktail	k o k̚ ˦˥ t aː j ˧˧
coi	k ɔ j ˧˧
con	k ɔ ŋ ˧˧
cong	k a w ŋ͡m ˧˧
constantinô	k ɔ ŋ ˧˧ s t aː ŋ ˧˧ t ɨ n ˧˧ n o w ˧˧
coronavirus	k ɔ ˧˧ ɹ o w ˧˧ n aː ˧˧ v ɪ j ˧˧ ɹ ʊ k͡p̚ ˦˥
cpcmltchmnvn	c ɨ n ˦˥ f ʊ w ˨˩˦ k a t̚ ˦˥ m aː ŋ ˨˩˨ l ə m ˧˧ tʰ əː j ˨˩ k ə w ŋ͡m ˨˩˨ w aː ˨˩ m i ə ŋ ˨˩ n aː m ˧˧ v i ə k̚ ˨˩˨ n aː m ˧˧
crom	k ɹ o m ˧˧
crôkê	k ɹ o w ˧˧ k e j ˧˧
csdl	k əː ˧˧ ʂ əː ˨˩˦ j ɨ ˨˩˦ l i w ˨˩˨
cttđvn	k aː k̚ ˦˥ tʰ a n ˦˥ t ɨ ˨˩˦ ʔ ɗ aː w ˨˩˨ v i ə k̚ ˨˩˨ n aː m ˧˧
cu	k ʊ w ˧˧
cua	k u ə ˧˧
cumingtonit	k əː ˧˧ m ɨ n ˧˧ t o w ˧˧ n ɨ t̚ ˦˥
cung	k ʊ w ŋ͡m ˧˧
curi	k ʊ w ˧˧ ɹ ɪ j ˧˧
cuốc	k u ə k̚ ˦˥
cuối	k u j ˦˥
cuốn	k u ə ŋ ˦˥
cuống	k u ə ŋ ˦˥
cuồng	k u ə ŋ ˨˩
cuộc	k u ə k̚ ˨˩˨
cuội	k u j ˨˩˨
cuộn	k u ə ŋ ˨˩˨
cà	k aː ˨˩
cài	k aː j ˨˩
càn	k aː ŋ ˨˩
càng	k aː ŋ ˨˩
cành	k a n ˨˩
cào	k aː w ˨˩
cày	k aː j ˨˩
cá	k aː ˦˥
các	k aː k̚ ˦˥
cách	k a t̚ ˦˥
cái	k aː j ˦˥
cám	k aː m ˦˥
cán	k aː ŋ ˦˥
cáng	k aː ŋ ˦˥
cánh	k a n ˦˥
cáo	k aː w ˦˥
cáp	k aː p̚ ˦˥
cát	k aː k̚ ˦˥
cáu	k aː w ˦˥
cáy	k aː j ˦˥
câm	k ə m ˧˧
cân	k ə ŋ ˧˧
câng	k ə ŋ ˧˧
câu	k ə w ˧˧
cây	k ə j ˧˧
cãi	k aː j ˨˩˦
cò	k ɔ ˨˩
còi	k ɔ j ˨˩
còm	k ɔ m ˨˩
còn	k ɔ ŋ ˨˩
còng	k a w ŋ͡m ˨˩
có	k ɔ ˦˥
cóc	k a w k͡p̚ ˦˥
cói	k ɔ j ˦˥
cóng	k a w ŋ͡m ˦˥
cót	k ɔ k̚ ˦˥
cô	k o w ˧˧
côi	k o j ˧˧
côn	k o ŋ ˧˧
công	k ə w ŋ͡m ˧˧
côngxoocxiom	k ə w ŋ͡m ˧˧ s ɔ k̚ ˦˥ s ɪ j ˧˧ ʔ ɔ m ˧˧
côrnêliô	k o w ˧˧ n e j ˧˧ l ɪ j ˧˧ ʔ o w ˧˧
côsin	k o w ˧˧ ʂ ɨ n ˧˧
côtang	k o w ˧˧ t aː ŋ ˧˧
cõi	k ɔ j ˨˩˦
cõng	k a w ŋ͡m ˨˩˦
cù	k ʊ w ˨˩
cùi	k u j ˨˩
cùm	k ʊ m ˨˩
cùn	k ʊ w ŋ͡m ˨˩
cùng	k ʊ w ŋ͡m ˨˩
cú	k ʊ w ˦˥
cúc	k ʊ w k͡p̚ ˦˥
cúi	k u j ˦˥
cúm	k ʊ m ˦˥
cún	k ʊ w ŋ͡m ˦˥
cúng	k ʊ w ŋ͡m ˦˥
cúp	k ʊ p̚ ˦˥
cút	k ʊ k͡p̚ ˦˥
căm	k a m ˧˧
căn	k a ŋ ˧˧
căng	k a ŋ ˧˧
cđ	k aː w ˧˧ ʔ ɗ a ŋ ˨˩˦
cđ	k ə w ŋ͡m ˨˩˨ ʔ ɗ ə w ŋ͡m ˨˩
cũ	k ʊ w ˨˩˦
cũi	k u j ˨˩˦
cũng	k ʊ w ŋ͡m ˨˩˦
cơ	k əː ˧˧
cơi	k əː j ˧˧
cơm	k əː m ˧˧
cơn	k əː ŋ ˧˧
cư	k ɨ ˧˧
cưa	k ɨ ə ˧˧
cưng	k ɨ ŋ ˧˧
cươi	k ɨ j ˧˧
cương	k ɨ ə ŋ ˧˧
cước	k ɨ ə k̚ ˦˥
cưới	k ɨ j ˦˥
cướp	k ɨ ə p̚ ˦˥
cười	k ɨ j ˨˩
cườm	k ɨ ə m ˨˩
cường	k ɨ ə ŋ ˨˩
cưỡi	k ɨ j ˨˩˦
cưỡng	k ɨ ə ŋ ˨˩˦
cược	k ɨ ə k̚ ˨˩˨
cạ	k aː ˨˩˨
cạc	k aː k̚ ˨˩˨
cạch	k a t̚ ˨˩˨
cạm	k aː m ˨˩˨
cạn	k aː ŋ ˨˩˨
cạnh	k a n ˨˩˨
cạo	k aː w ˨˩˨
cạp	k aː p̚ ˨˩˨
cạy	k aː j ˨˩˨
cả	k aː ˨˩˦
cải	k aː j ˨˩˦
cảm	k aː m ˨˩˦
cản	k aː ŋ ˨˩˦
cảng	k aː ŋ ˨˩˦
cảnh	k a n ˨˩˦
cấm	k ə m ˦˥
cấp	k ə p̚ ˦˥
cất	k ə k̚ ˦˥
cấu	k ə w ˦˥
cấy	k ə j ˦˥
cầm	k ə m ˨˩
cần	k ə ŋ ˨˩
cầu	k ə w ˨˩
cầy	k ə j ˨˩
cẩm	k ə m ˨˩˦
cẩu	k ə w ˨˩˦
cận	k ə ŋ ˨˩˨
cật	k ə k̚ ˨˩˨
cậu	k ə w ˨˩˨
cậy	k ə j ˨˩˨
cắc	k a k̚ ˦˥
cắm	k a m ˦˥
cắn	k a ŋ ˦˥
cắp	k a p̚ ˦˥
cắt	k a k̚ ˦˥
cằm	k a m ˨˩
cẳng	k a ŋ ˨˩˦
cặc	k a k̚ ˨˩˨
cặn	k a ŋ ˨˩˨
cặp	k a p̚ ˨˩˨
cọ	k ɔ ˨˩˨
cọc	k a w k͡p̚ ˨˩˨
cọng	k a w ŋ͡m ˨˩˨
cọp	k ɔ p̚ ˨˩˨
cỏ	k ɔ ˨˩˦
cố	k o w ˦˥
cốc	k ə w k͡p̚ ˦˥
cối	k o j ˦˥
cốm	k o m ˦˥
cống	k ə w ŋ͡m ˦˥
cốp	k o p̚ ˦˥
cốt	k o k̚ ˦˥
cồn	k o ŋ ˨˩
cồng	k ə w ŋ͡m ˨˩
cổ	k o w ˨˩˦
cổng	k ə w ŋ͡m ˨˩˦
cỗ	k o w ˨˩˦
cỗi	k o j ˨˩˦
cộ	k o w ˨˩˨
cội	k o j ˨˩˨
cộm	k o m ˨˩˨
cộng	k ə w ŋ͡m ˨˩˨
cột	k o k̚ ˨˩˨
cớ	k əː ˦˥
cớm	k əː m ˦˥
cờ	k əː ˨˩
cởi	k əː j ˨˩˦
cỡ	k əː ˨˩˦
cỡi	k əː j ˨˩˦
cụ	k ʊ w ˨˩˨
cục	k ʊ w k͡p̚ ˨˩˨
cụm	k ʊ m ˨˩˨
cụng	k ʊ w ŋ͡m ˨˩˨
cụp	k ʊ p̚ ˨˩˨
cụt	k ʊ k͡p̚ ˨˩˨
củ	k ʊ w ˨˩˦
của	k u ə ˨˩˦
củi	k u j ˨˩˦
cứ	k ɨ ˦˥
cứa	k ɨ ə ˦˥
cứng	k ɨ ŋ ˦˥
cứt	k ɨ k̚ ˦˥
cứu	k ɨ w ˦˥
cừu	k ɨ w ˨˩
cử	k ɨ ˨˩˦
cửa	k ɨ ə ˨˩˦
cửi	k ɨ j ˨˩˦
cửu	k ɨ w ˨˩˦
cự	k ɨ ˨˩˨
cựa	k ɨ ə ˨˩˨
cực	k ɨ k̚ ˨˩˨
cựu	k ɨ w ˨˩˨
d	j e j ˧˧
da	j aː ˧˧
dai	j aː j ˧˧
dam	j aː m ˧˧
dang	j aː ŋ ˧˧
danh	j a n ˧˧
dao	j aː w ˧˧
decimet	ʔ ɗ e j ˧˧ s ɪ j ˧˧ m ɛ k̚ ˦˥
dinh	j ɨ n ˧˧
diêm	j i m ˧˧
diếp	j i p̚ ˦˥
diều	j i w ˨˩
diễn	j i ə ŋ ˨˩˦
diệc	j i ə k̚ ˨˩˨
diện	j i ə ŋ ˨˩˨
diệp	j i p̚ ˨˩˨
diệt	j i ə k̚ ˨˩˨
diệu	j i w ˨˩˨
do	j ɔ ˧˧
dom	j ɔ m ˧˧
don	j ɔ ŋ ˧˧
dong	j a w ŋ͡m ˧˧
doạ	j ⁽ʷ ⁾ aː ˨˩˨
du	j ʊ w ˧˧
dung	j ʊ w ŋ͡m ˧˧
duy	j ⁽ʷ ⁾ ɪ j ˧˧
duyên	j ⁽ʷ ⁾ i ə ŋ ˧˧
duyệt	j ⁽ʷ ⁾ i ə k̚ ˨˩˨
duối	j u j ˦˥
duỗi	j u j ˨˩˦
dzô	j o w ˧˧
dài	j aː j ˨˩
dàn	j aː ŋ ˨˩
dành	j a n ˨˩
dày	j aː j ˨˩
dái	j aː j ˦˥
dám	j aː m ˦˥
dán	j aː ŋ ˦˥
dáng	j aː ŋ ˦˥
dâm	j ə m ˧˧
dân	j ə ŋ ˧˧
dâng	j ə ŋ ˧˧
dâu	j ə w ˧˧
dây	j ə j ˧˧
dã	j aː ˨˩˦
dãi	j aː j ˨˩˦
dãn	j aː ŋ ˨˩˦
dãy	j aː j ˨˩˦
dè	j ɛ ˨˩
dép	j ɛ p̚ ˦˥
dét	j ɛ k̚ ˦˥
dê	j e j ˧˧
dì	j ɪ j ˨˩
dìm	j i m ˨˩
dìu	j i w ˨˩
dí	j ɪ j ˦˥
dím	j i m ˦˥
dính	j ɨ n ˦˥
dò	j ɔ ˨˩
dòm	j ɔ m ˨˩
dòng	j a w ŋ͡m ˨˩
dóc	j a w k͡p̚ ˦˥
dóm	j ɔ m ˦˥
dô	j o w ˧˧
dông	j ə w ŋ͡m ˧˧
dõi	j ɔ j ˨˩˦
dù	j ʊ w ˨˩
dùi	j u j ˨˩
dùm	j ʊ m ˨˩
dùng	j ʊ w ŋ͡m ˨˩
dúi	j u j ˦˥
dúm	j ʊ m ˦˥
dăm	j a m ˧˧
dĩ	j ɪ j ˨˩˦
dĩa	j i ə ˨˩˦
dũng	j ʊ w ŋ͡m ˨˩˦
dơ	j əː ˧˧
dơi	j əː j ˧˧
dư	j ɨ ˧˧
dưa	j ɨ ə ˧˧
dưng	j ɨ ŋ ˧˧
dương	j ɨ ə ŋ ˧˧
dưới	j ɨ j ˦˥
dường	j ɨ ə ŋ ˨˩
dưỡng	j ɨ ə ŋ ˨˩˦
dược	j ɨ ə k̚ ˨˩˨
dượng	j ɨ ə ŋ ˨˩˨
dượt	j ɨ ə k̚ ˨˩˨
dạ	j aː ˨˩˨
dại	j aː j ˨˩˨
dạn	j aː ŋ ˨˩˨
dạng	j aː ŋ ˨˩˨
dạo	j aː w ˨˩˨
dạy	j aː j ˨˩˨
dải	j aː j ˨˩˦
dấn	j ə ŋ ˦˥
dấu	j ə w ˦˥
dấy	j ə j ˦˥
dầm	j ə m ˨˩
dần	j ə ŋ ˨˩
dầu	j ə w ˨˩
dẫn	j ə ŋ ˨˩˦
dẫu	j ə w ˨˩˦
dậm	j ə m ˨˩˨
dập	j ə p̚ ˨˩˨
dậu	j ə w ˨˩˨
dậy	j ə j ˨˩˨
dắt	j a k̚ ˦˥
dằm	j a m ˨˩
dằn	j a ŋ ˨˩
dặm	j a m ˨˩˨
dặn	j a ŋ ˨˩˨
dẹp	j ɛ p̚ ˨˩˨
dẹt	j ɛ k̚ ˨˩˨
dẻ	j ɛ ˨˩˦
dẻo	j ɛ w ˨˩˦
dẽ	j ɛ ˨˩˦
dế	j e j ˦˥
dền	j əː n ˨˩
dễ	j e j ˨˩˦
dệt	j əː t̚ ˨˩˨
dịch	j ɨ t̚ ˨˩˨
dịp	j i p̚ ˨˩˨
dịu	j i w ˨˩˨
dọc	j a w k͡p̚ ˨˩˨
dọn	j ɔ ŋ ˨˩˨
dỏ	j ɔ ˨˩˦
dỏm	j ɔ m ˨˩˦
dốc	j ə w k͡p̚ ˦˥
dối	j o j ˦˥
dốt	j o k̚ ˦˥
dồi	j o j ˨˩
dồn	j o ŋ ˨˩
dỗ	j o w ˨˩˦
dỗi	j o j ˨˩˦
dộc	j ə w k͡p̚ ˨˩˨
dội	j o j ˨˩˨
dộng	j ə w ŋ͡m ˨˩˨
dột	j o k̚ ˨˩˨
dớp	j əː p̚ ˦˥
dớt	j əː k̚ ˦˥
dời	j əː j ˨˩
dở	j əː ˨˩˦
dởm	j əː m ˨˩˦
dỡ	j əː ˨˩˦
dợm	j əː m ˨˩˨
dụ	j ʊ w ˨˩˨
dục	j ʊ w k͡p̚ ˨˩˨
dụng	j ʊ w ŋ͡m ˨˩˨
dứa	j ɨ ə ˦˥
dức	j ɨ k̚ ˦˥
dứt	j ɨ k̚ ˦˥
dừa	j ɨ ə ˨˩
dừng	j ɨ ŋ ˨˩
dử	j ɨ ˨˩˦
dửng	j ɨ ŋ ˨˩˦
dữ	j ɨ ˨˩˦
dự	j ɨ ˨˩˨
dựa	j ɨ ə ˨˩˨
dựng	j ɨ ŋ ˨˩˨
e	ʔ ɛ ˧˧
electron	ʔ ɛ ˧˧ l ɛ k̚ ˦˥ ʈ ə w ŋ͡m ˧˧
elip	ʔ ɛ ˧˧ l i p̚ ˦˥
em	ʔ ɛ m ˧˧
ensteni	ʔ ɛ ŋ ˧˧ s t ɛ ˧˧ n ɪ j ˧˧
eo	ʔ ɛ w ˧˧
eribi	ʔ ɛ ˧˧ ɹ ɪ j ˧˧ ʔ ɓ ɪ j ˧˧
eu	ʔ ɛ ˧˧ ʔ ʊ w ˧˧
europi	ʔ e w ˧˧ ɹ o w ˧˧ p ɪ j ˧˧
fa	ʔ ɛ p̚ ˦˥ f əː ˨˩ ʔ aː ˧˧
fara	f aː ˧˧ ɹ aː ˧˧
fecmi	f ɛ k̚ ˦˥ m ɪ j ˧˧
flerovi	f l e j ˧˧ ɹ ɔ ˧˧ v ɪ j ˧˧
flo	f l ɔ ˧˧
franxi	f ɹ aː ŋ ˧˧ s ɪ j ˧˧
fêlix	f e j ˧˧ l ɨ t̚ ˦˥
g	j e j ˧˧
g	ɣ əː ˨˩
ga	ɣ aː ˧˧
gai	ɣ aː j ˧˧
gali	ɣ aː ˧˧ l ɪ j ˧˧
gam	ɣ aː m ˧˧
gan	ɣ aː ŋ ˧˧
gang	ɣ aː ŋ ˧˧
ganh	ɣ a n ˧˧
gato	ɣ aː ˧˧ t ɔ ˧˧
gay	ɣ aː j ˧˧
gađolini	ɣ aː ˧˧ ʔ ɗ o w ˧˧ l ɪ j ˧˧ n ɪ j ˧˧
gemani	j ɛ ˧˧ m aː ˧˧ n ɪ j ˧˧
gen	j ɛ ŋ ˧˧
ghe	ɣ ɛ ˧˧
ghen	ɣ ɛ ŋ ˧˧
ghi	ɣ ɪ j ˧˧
ghim	ɣ i m ˧˧
ghiền	ɣ i ə ŋ ˨˩
ghè	ɣ ɛ ˨˩
ghèn	ɣ ɛ ŋ ˨˩
ghé	ɣ ɛ ˦˥
ghép	ɣ ɛ p̚ ˦˥
ghét	ɣ ɛ k̚ ˦˥
ghê	ɣ e j ˧˧
ghì	ɣ ɪ j ˨˩
ghìm	ɣ i m ˨˩
ghẹ	ɣ ɛ ˨˩˨
ghẹo	ɣ ɛ w ˨˩˨
ghẻ	ɣ ɛ ˨˩˦
ghế	ɣ e j ˦˥
ghệ	ɣ e j ˨˩˨
ghệt	ɣ əː t̚ ˨˩˨
gi	j ɪ j ˧˧
gia	j aː ˧˧
giacôbê	j aː ˧˧ k o w ˧˧ ʔ ɓ e j ˧˧
giai	j aː j ˧˧
giam	j aː m ˧˧
gian	j aː ŋ ˧˧
giang	j aː ŋ ˧˧
giao	j aː w ˧˧
gieo	j ɛ w ˧˧
gio	j ɔ ˧˧
gioan	j w aː ŋ ˧˧
giong	j a w ŋ͡m ˧˧
giuliô	j ʊ w ˧˧ l ɪ j ˧˧ ʔ o w ˧˧
giun	j ʊ w ŋ͡m ˧˧
giuse	j ʊ w ˧˧ ʂ ɛ ˧˧
giuđa	j ʊ w ˧˧ ʔ ɗ aː ˧˧
giuộc	j u ə k̚ ˨˩˨
già	j aː ˨˩
giàn	j aː ŋ ˨˩
giàng	j aː ŋ ˨˩
giành	j a n ˨˩
giàu	j aː w ˨˩
giày	j aː j ˨˩
giá	j aː ˦˥
giác	j aː k̚ ˦˥
gián	j aː ŋ ˦˥
giáng	j aː ŋ ˦˥
giáo	j aː w ˦˥
giáp	j aː p̚ ˦˥
giáy	j aː j ˦˥
giâm	j ə m ˧˧
giây	j ə j ˧˧
giã	j aː ˨˩˦
giãi	j aː j ˨˩˦
giãn	j aː ŋ ˨˩˦
giãy	j aː j ˨˩˦
gié	j ɛ ˦˥
giê	j e j ˧˧
giêng	j i ə ŋ ˧˧
giêsu	j e j ˧˧ ʂ ʊ w ˧˧
giò	j ɔ ˨˩
giòi	j ɔ j ˨˩
giòn	j ɔ ŋ ˨˩
gió	j ɔ ˦˥
gióc	j a w k͡p̚ ˦˥
gióng	j a w ŋ͡m ˦˥
giông	j ə w ŋ͡m ˧˧
giùi	j u j ˨˩
giùm	j ʊ m ˨˩
giú	j ʊ w ˦˥
giúp	j ʊ p̚ ˦˥
giăm	j a m ˧˧
giăng	j a ŋ ˧˧
giũ	j ʊ w ˨˩˦
giũa	j u ə ˨˩˦
giơ	j əː ˧˧
giương	j ɨ ə ŋ ˧˧
giường	j ɨ ə ŋ ˨˩
giạng	j aː ŋ ˨˩˨
giạt	j aː k̚ ˨˩˨
giả	j aː ˨˩˦
giải	j aː j ˨˩˦
giảm	j aː m ˨˩˦
giảng	j aː ŋ ˨˩˦
giảnh	j a n ˨˩˦
giảo	j aː w ˨˩˦
giấc	j ə k̚ ˦˥
giấm	j ə m ˦˥
giấu	j ə w ˦˥
giấy	j ə j ˦˥
giầm	j ə m ˨˩
giầu	j ə w ˨˩
giầy	j ə j ˨˩
giẫm	j ə m ˨˩˦
giậm	j ə m ˨˩˨
giận	j ə ŋ ˨˩˨
giập	j ə p̚ ˨˩˨
giật	j ə k̚ ˨˩˨
giậu	j ə w ˨˩˨
giằm	j a m ˨˩
giặc	j a k̚ ˨˩˨
giặt	j a k̚ ˨˩˨
giẹp	j ɛ p̚ ˨˩˨
giẻ	j ɛ ˨˩˦
giếm	j i m ˦˥
giếng	j i ə ŋ ˦˥
giết	j i ə k̚ ˦˥
giền	j əː n ˨˩
giềng	j i ə ŋ ˨˩
giễu	j i w ˨˩˦
giọi	j ɔ j ˨˩˨
giọng	j a w ŋ͡m ˨˩˨
giọt	j ɔ k̚ ˨˩˨
giỏ	j ɔ ˨˩˦
giỏi	j ɔ j ˨˩˦
giống	j ə w ŋ͡m ˦˥
giồng	j ə w ŋ͡m ˨˩
giỗ	j o w ˨˩˦
giội	j o j ˨˩˨
giới	j əː j ˦˥
giờ	j əː ˨˩
giời	j əː j ˨˩
giở	j əː ˨˩˦
giỡn	j əː ŋ ˨˩˦
giục	j ʊ w k͡p̚ ˨˩˨
giụi	j u j ˨˩˨
giừ	j ɨ ˨˩
giữ	j ɨ ˨˩˦
giữa	j ɨ ə ˨˩˦
giựt	j ɨ k̚ ˨˩˨
go	ɣ ɔ ˧˧
golf	ɣ o ŋ ˧˧
gom	ɣ ɔ m ˧˧
goá	ɣ w aː ˦˥
grêgôriô	ɹ e j ˧˧ ɣ o w ˧˧ ɹ ɪ j ˧˧ ʔ o w ˧˧
gu	ɣ ʊ w ˧˧
guốc	ɣ u ə k̚ ˦˥
guồng	ɣ u ə ŋ ˨˩
gà	ɣ aː ˨˩
gài	ɣ aː j ˨˩
gàn	ɣ aː ŋ ˨˩
gào	ɣ aː w ˨˩
gàu	ɣ aː w ˨˩
gác	ɣ aː k̚ ˦˥
gái	ɣ aː j ˦˥
gán	ɣ aː ŋ ˦˥
gánh	ɣ a n ˦˥
gáo	ɣ aː w ˦˥
gáy	ɣ aː j ˦˥
gân	ɣ ə ŋ ˧˧
gâu	ɣ ə w ˧˧
gây	ɣ ə j ˧˧
gã	ɣ aː ˨˩˦
gãi	ɣ aː j ˨˩˦
gãy	ɣ aː j ˨˩˦
gì	j ɪ j ˨˩
gìn	j ɨ n ˨˩
gò	ɣ ɔ ˨˩
góc	ɣ a w k͡p̚ ˦˥
gói	ɣ ɔ j ˦˥
góp	ɣ ɔ p̚ ˦˥
gót	ɣ ɔ k̚ ˦˥
gôm	ɣ o m ˧˧
gôn	ɣ o ŋ ˧˧
gông	ɣ ə w ŋ͡m ˧˧
gõ	ɣ ɔ ˨˩˦
gù	ɣ ʊ w ˨˩
gùi	ɣ u j ˨˩
gút	ɣ ʊ k͡p̚ ˦˥
găm	ɣ a m ˧˧
găng	ɣ a ŋ ˧˧
gươm	ɣ ɨ ə m ˧˧
gương	ɣ ɨ ə ŋ ˧˧
gượm	ɣ ɨ ə m ˨˩˨
gượng	ɣ ɨ ə ŋ ˨˩˨
gạ	ɣ aː ˨˩˨
gạc	ɣ aː k̚ ˨˩˨
gạch	ɣ a t̚ ˨˩˨
gạo	ɣ aː w ˨˩˨
gạt	ɣ aː k̚ ˨˩˨
gả	ɣ aː ˨˩˦
gảy	ɣ aː j ˨˩˦
gấc	ɣ ə k̚ ˦˥
gấm	ɣ ə m ˦˥
gấp	ɣ ə p̚ ˦˥
gấu	ɣ ə w ˦˥
gấy	ɣ ə j ˦˥
gầm	ɣ ə m ˨˩
gần	ɣ ə ŋ ˨˩
gầy	ɣ ə j ˨˩
gẫm	ɣ ə m ˨˩˦
gập	ɣ ə p̚ ˨˩˨
gật	ɣ ə k̚ ˨˩˨
gậy	ɣ ə j ˨˩˨
gắn	ɣ a ŋ ˦˥
gắng	ɣ a ŋ ˦˥
gắp	ɣ a p̚ ˦˥
gắt	ɣ a k̚ ˦˥
gằn	ɣ a ŋ ˨˩
gặm	ɣ a m ˨˩˨
gặng	ɣ a ŋ ˨˩˨
gặp	ɣ a p̚ ˨˩˨
gặt	ɣ a k̚ ˨˩˨
gọi	ɣ ɔ j ˨˩˨
gọn	ɣ ɔ ŋ ˨˩˨
gọng	ɣ a w ŋ͡m ˨˩˨
gọt	ɣ ɔ k̚ ˨˩˨
gỏi	ɣ ɔ j ˨˩˦
gốc	ɣ ə w k͡p̚ ˦˥
gối	ɣ o j ˦˥
gốm	ɣ o m ˦˥
gồm	ɣ o m ˨˩
gồng	ɣ ə w ŋ͡m ˨˩
gỗ	ɣ o w ˨˩˦
gộc	ɣ ə w k͡p̚ ˨˩˨
gội	ɣ o j ˨˩˨
gộp	ɣ o p̚ ˨˩˨
gớm	ɣ əː m ˦˥
gờ	ɣ əː ˨˩
gờm	ɣ əː m ˨˩
gở	ɣ əː ˨˩˦
gởi	ɣ əː j ˨˩˦
gỡ	ɣ əː ˨˩˦
gợi	ɣ əː j ˨˩˨
gợn	ɣ əː ŋ ˨˩˨
gục	ɣ ʊ w k͡p̚ ˨˩˨
gừng	ɣ ɨ ŋ ˨˩
gửi	ɣ ɨ j ˨˩˦
h	h a k̚ ˦˥
h'mông	h əː ˨˩ m ə w ŋ͡m ˧˧
ha	h aː ˧˧
hafini	h aː ˧˧ f ɪ j ˧˧ n ɪ j ˧˧
hai	h aː j ˧˧
ham	h aː m ˧˧
hang	h aː ŋ ˧˧
hao	h aː w ˧˧
hay	h aː j ˧˧
heli	h e j ˧˧ l ɪ j ˧˧
hen	h ɛ ŋ ˧˧
heo	h ɛ w ˧˧
hi	h ɪ j ˧˧
hia	h i ə ˧˧
hic	h ɨ t̚ ˦˥
hilariô	h ɪ j ˧˧ l aː ˧˧ ɹ ɪ j ˧˧ ʔ o w ˧˧
hiu	h i w ˧˧
hiên	h i ə ŋ ˧˧
hiđro	h ɪ j ˧˧ ʔ ɗ ɹ o w ˧˧
hiếm	h i m ˦˥
hiến	h i ə ŋ ˦˥
hiếp	h i p̚ ˦˥
hiếu	h i w ˦˥
hiền	h i ə ŋ ˨˩
hiểm	h i m ˨˩˦
hiển	h i ə ŋ ˨˩˦
hiểu	h i w ˨˩˦
hiện	h i ə ŋ ˨˩˨
hiệp	h i p̚ ˨˩˨
hiệu	h i w ˨˩˨
ho	h ɔ ˧˧
hoa	w aː ˧˧
hoang	w aː ŋ ˧˧
hoen	w ɛ ŋ ˧˧
hoi	h ɔ j ˧˧
hong	h a w ŋ͡m ˧˧
honmi	h o n ˧˧ m ɪ j ˧˧
hoà	w aː ˨˩
hoài	w aː j ˨˩
hoàn	w aː ŋ ˨˩
hoàng	w aː ŋ ˨˩
hoá	w aː ˦˥
hoãn	w aː ŋ ˨˩˦
hoè	w ɛ ˨˩
hoạ	w aː ˨˩˨
hoạn	w aː ŋ ˨˩˨
hoả	w aː ˨˩˦
hoảng	w aː ŋ ˨˩˦
hoắc	w a k̚ ˦˥
hoẵng	w a ŋ ˨˩˦
hoặc	w a k̚ ˨˩˨
hrê	h ɹ e j ˧˧
hun	h ʊ w ŋ͡m ˧˧
hung	h ʊ w ŋ͡m ˧˧
huy	w ɪ j ˧˧
huynh	w ɨ n ˧˧
huyết	w i ə k̚ ˦˥
huyền	w i ə ŋ ˨˩
huyện	w i ə ŋ ˨˩˨
huyệt	w i ə k̚ ˨˩˨
huân	w ə ŋ ˧˧
huýt	w ɨ t̚ ˦˥
huơ	w əː ˧˧
huế	w e j ˦˥
huề	w e j ˨˩
huệ	w e j ˨˩˨
huống	h u ə ŋ ˦˥
huỳnh	w ɨ n ˨˩
huỷ	w ɪ j ˨˩˦
hyginô	h ɪ j ˧˧ j ɪ j ˧˧ n o w ˧˧
hypebol	h ɪ j ˧˧ p ɛ ˧˧ ʔ ɓ ɔ ŋ ˧˧
hà	h aː ˨˩
hài	h aː j ˨˩
hàm	h aː m ˨˩
hàn	h aː ŋ ˨˩
hàng	h aː ŋ ˨˩
hành	h a n ˨˩
hào	h aː w ˨˩
hàu	h aː w ˨˩
há	h aː ˦˥
hái	h aː j ˦˥
hán	h aː ŋ ˦˥
háng	h aː ŋ ˦˥
háo	h aː w ˦˥
hát	h aː k̚ ˦˥
hâm	h ə m ˧˧
hãi	h aː j ˨˩˦
hãm	h aː m ˨˩˦
hãn	h aː ŋ ˨˩˦
hãng	h aː ŋ ˨˩˦
hãy	h aː j ˨˩˦
hè	h ɛ ˨˩
hèm	h ɛ m ˨˩
hèn	h ɛ ŋ ˨˩
hé	h ɛ ˦˥
héo	h ɛ w ˦˥
hét	h ɛ k̚ ˦˥
hên	h əː n ˧˧
hình	h ɨ n ˨˩
hí	h ɪ j ˦˥
hít	h ɨ t̚ ˦˥
hò	h ɔ ˨˩
hòm	h ɔ m ˨˩
hòn	h ɔ ŋ ˨˩
hòng	h a w ŋ͡m ˨˩
hóc	h a w k͡p̚ ˦˥
hói	h ɔ j ˦˥
hóng	h a w ŋ͡m ˦˥
hóp	h ɔ p̚ ˦˥
hót	h ɔ k̚ ˦˥
hô	h o w ˧˧
hôi	h o j ˧˧
hôm	h o m ˧˧
hôn	h o ŋ ˧˧
hông	h ə w ŋ͡m ˧˧
hù	h ʊ w ˨˩
hùa	h u ə ˨˩
hùm	h ʊ m ˨˩
hùng	h ʊ w ŋ͡m ˨˩
hú	h ʊ w ˦˥
húc	h ʊ w k͡p̚ ˦˥
húp	h ʊ p̚ ˦˥
hút	h ʊ k͡p̚ ˦˥
hăm	h a m ˧˧
hăng	h a ŋ ˧˧
hĩm	h i m ˨˩˦
hũ	h ʊ w ˨˩˦
hơ	h əː ˧˧
hơi	h əː j ˧˧
hơn	h əː ŋ ˧˧
hư	h ɨ ˧˧
hưu	h ɨ w ˧˧
hương	h ɨ ə ŋ ˧˧
hươu	h ɨ ə w ˧˧
hướng	h ɨ ə ŋ ˦˥
hường	h ɨ ə ŋ ˨˩
hưởng	h ɨ ə ŋ ˨˩˦
hạ	h aː ˨˩˨
hạc	h aː k̚ ˨˩˨
hạch	h a t̚ ˨˩˨
hại	h aː j ˨˩˨
hạm	h aː m ˨˩˨
hạn	h aː ŋ ˨˩˨
hạng	h aː ŋ ˨˩˨
hạnh	h a n ˨˩˨
hạo	h aː w ˨˩˨
hạp	h aː p̚ ˨˩˨
hạt	h aː k̚ ˨˩˨
hả	h aː ˨˩˦
hải	h aː j ˨˩˦
hảo	h aː w ˨˩˦
hấp	h ə p̚ ˦˥
hất	h ə k̚ ˦˥
hầm	h ə m ˨˩
hầu	h ə w ˨˩
hẩy	h ə j ˨˩˦
hận	h ə ŋ ˨˩˨
hậu	h ə w ˨˩˨
hắc	h a k̚ ˦˥
hắn	h a ŋ ˦˥
hắt	h a k̚ ˦˥
hằng	h a ŋ ˨˩
hẳn	h a ŋ ˨˩˦
hẵng	h a ŋ ˨˩˦
hẹ	h ɛ ˨˩˨
hẹn	h ɛ ŋ ˨˩˨
hẹp	h ɛ p̚ ˨˩˨
hẻm	h ɛ m ˨˩˦
hếch	h əː t̚ ˦˥
hến	h əː n ˦˥
hết	h əː t̚ ˦˥
hề	h e j ˨˩
hễ	h e j ˨˩˦
hệch	h əː t̚ ˨˩˨
hệt	h əː t̚ ˨˩˨
hỉ	h ɪ j ˨˩˦
hịch	h ɨ t̚ ˨˩˨
họ	h ɔ ˨˩˨
học	h a w k͡p̚ ˨˩˨
họng	h a w ŋ͡m ˨˩˨
họp	h ɔ p̚ ˨˩˨
hỏi	h ɔ j ˨˩˦
hỏng	h a w ŋ͡m ˨˩˦
hố	h o w ˦˥
hốc	h ə w k͡p̚ ˦˥
hối	h o j ˦˥
hốt	h o k̚ ˦˥
hồ	h o w ˨˩
hồi	h o j ˨˩
hồn	h o ŋ ˨˩
hồng	h ə w ŋ͡m ˨˩
hổ	h o w ˨˩˦
hổi	h o j ˨˩˦
hổm	h o m ˨˩˦
hổng	h ə w ŋ͡m ˨˩˦
hỗ	h o w ˨˩˦
hỗn	h o ŋ ˨˩˦
hộ	h o w ˨˩˨
hộc	h ə w k͡p̚ ˨˩˨
hội	h o j ˨˩˨
hộp	h o p̚ ˨˩˨
hột	h o k̚ ˨˩˨
hớn	h əː ŋ ˦˥
hớp	h əː p̚ ˦˥
hớt	h əː k̚ ˦˥
hời	h əː j ˨˩
hờn	h əː ŋ ˨˩
hở	h əː ˨˩˦
hỡi	h əː j ˨˩˦
hợi	h əː j ˨˩˨
hợm	h əː m ˨˩˨
hợp	h əː p̚ ˨˩˨
hụ	h ʊ w ˨˩˨
hụp	h ʊ p̚ ˨˩˨
hụt	h ʊ k͡p̚ ˨˩˨
hủ	h ʊ w ˨˩˦
hứa	h ɨ ə ˦˥
hức	h ɨ k̚ ˦˥
hứng	h ɨ ŋ ˦˥
hử	h ɨ ˨˩˦
hửi	h ɨ j ˨˩˦
hửng	h ɨ ŋ ˨˩˦
hữu	h ɨ w ˨˩˦
i	ʔ ɪ j ˧˧
im	ʔ i m ˧˧
in	ʔ ɨ n ˧˧
inh	ʔ ɨ n ˧˧
inhaxiô	ʔ ɪ j ˧˧ ɲ aː ˧˧ s ɪ j ˧˧ ʔ o w ˧˧
inđi	ʔ ɨ n ˧˧ ʔ ɗ ɪ j ˧˧
ion	ʔ ɪ j ˧˧ ʔ ə w ŋ͡m ˧˧
iot	ʔ ɪ j ˧˧ ʔ o k̚ ˦˥
iriđi	ʔ ɪ j ˧˧ ɹ ɪ j ˧˧ ʔ ɗ ɪ j ˧˧
isave	ʔ ɪ j ˧˧ ʂ aː ˧˧ v ɛ ˧˧
iu	ʔ i w ˧˧
k	k aː ˧˧
kaki	k aː ˧˧ k ɪ j ˧˧
kali	k aː ˧˧ l ɪ j ˧˧
ke	k ɛ ˧˧
kem	k ɛ m ˧˧
ken	k ɛ ŋ ˧˧
keng	k ɛ ŋ ˧˧
kenvin	k ɛ ŋ ˧˧ v ɨ n ˧˧
keo	k ɛ w ˧˧
khai	kʰ aː j ˧˧
khan	kʰ aː ŋ ˧˧
khanh	kʰ a n ˧˧
khay	kʰ aː j ˧˧
khe	kʰ ɛ ˧˧
khen	kʰ ɛ ŋ ˧˧
khi	kʰ ɪ j ˧˧
khinh	kʰ ɨ n ˧˧
khiên	kʰ i ə ŋ ˧˧
khiêng	kʰ i ə ŋ ˧˧
khiến	kʰ i ə ŋ ˦˥
khiếp	kʰ i p̚ ˦˥
khiếu	kʰ i w ˦˥
kho	kʰ ɔ ˧˧
khoa	kʰ w aː ˧˧
khoai	kʰ w aː j ˧˧
khoan	kʰ w aː ŋ ˧˧
khoang	kʰ w aː ŋ ˧˧
khoanh	kʰ w a n ˧˧
khoe	kʰ w ɛ ˧˧
khoeo	kʰ w ɛ w ˧˧
khom	kʰ ɔ m ˧˧
khoá	kʰ w aː ˦˥
khoác	kʰ w aː k̚ ˦˥
khoái	kʰ w aː j ˦˥
khoán	kʰ w aː ŋ ˦˥
khoáng	kʰ w aː ŋ ˦˥
khoát	kʰ w aː k̚ ˦˥
khoé	kʰ w ɛ ˦˥
khoét	kʰ w ɛ k̚ ˦˥
khoả	kʰ w aː ˨˩˦
khoản	kʰ w aː ŋ ˨˩˦
khoảng	kʰ w aː ŋ ˨˩˦
khoảnh	kʰ w a n ˨˩˦
khoằm	kʰ w a m ˨˩
khoẻ	kʰ w ɛ ˨˩˦
khu	kʰ ʊ w ˧˧
khui	kʰ u j ˧˧
khum	kʰ ʊ m ˧˧
khung	kʰ ʊ w ŋ͡m ˧˧
khuy	kʰ w ɪ j ˧˧
khuya	kʰ w i ə ˧˧
khuyên	kʰ w i ə ŋ ˧˧
khuyến	kʰ w i ə ŋ ˦˥
khuyết	kʰ w i ə k̚ ˦˥
khuân	kʰ w ə ŋ ˧˧
khuôn	kʰ u ə ŋ ˧˧
khuất	kʰ w ə k̚ ˦˥
khuấy	kʰ w ə j ˦˥
khuếch	kʰ w əː t̚ ˦˥
khuỷu	kʰ w i w ˨˩˦
khàn	kʰ aː ŋ ˨˩
khá	kʰ aː ˦˥
khác	kʰ aː k̚ ˦˥
khách	kʰ a t̚ ˦˥
khái	kʰ aː j ˦˥
khám	kʰ aː m ˦˥
khán	kʰ aː ŋ ˦˥
kháng	kʰ aː ŋ ˦˥
khánh	kʰ a n ˦˥
khát	kʰ aː k̚ ˦˥
kháy	kʰ aː j ˦˥
khâu	kʰ ə w ˧˧
khéo	kʰ ɛ w ˦˥
khép	kʰ ɛ p̚ ˦˥
khét	kʰ ɛ k̚ ˦˥
khê	kʰ e j ˧˧
khêu	kʰ e w ˧˧
khí	kʰ ɪ j ˦˥
khía	kʰ i ə ˦˥
khích	kʰ ɨ t̚ ˦˥
khít	kʰ ɨ t̚ ˦˥
khó	kʰ ɔ ˦˥
khóc	kʰ a w k͡p̚ ˦˥
khói	kʰ ɔ j ˦˥
khóm	kʰ ɔ m ˦˥
khô	kʰ o w ˧˧
khôi	kʰ o j ˧˧
khôn	kʰ o ŋ ˧˧
không	kʰ ə w ŋ͡m ˧˧
khùng	kʰ ʊ w ŋ͡m ˨˩
khúc	kʰ ʊ w k͡p̚ ˦˥
khăm	kʰ a m ˧˧
khăn	kʰ a ŋ ˧˧
khơi	kʰ əː j ˧˧
khương	kʰ ɨ ə ŋ ˧˧
khạc	kʰ aː k̚ ˨˩˨
khả	kʰ aː ˨˩˦
khải	kʰ aː j ˨˩˦
khảnh	kʰ a n ˨˩˦
khảo	kʰ aː w ˨˩˦
khảy	kʰ aː j ˨˩˦
khấn	kʰ ə ŋ ˦˥
khấu	kʰ ə w ˦˥
khẩu	kʰ ə w ˨˩˦
khắc	kʰ a k̚ ˦˥
khắm	kʰ a m ˦˥
khắp	kʰ a p̚ ˦˥
khẳn	kʰ a ŋ ˨˩˦
khẹc	kʰ ɛ k̚ ˨˩˨
khẽ	kʰ ɛ ˨˩˦
khế	kʰ e j ˦˥
khều	kʰ e w ˨˩
khểnh	kʰ əː n ˨˩˦
khỉ	kʰ ɪ j ˨˩˦
khịt	kʰ ɨ t̚ ˨˩˨
khỏ	kʰ ɔ ˨˩˦
khỏi	kʰ ɔ j ˨˩˦
khố	kʰ o w ˦˥
khối	kʰ o j ˦˥
khổ	kʰ o w ˨˩˦
khổng	kʰ ə w ŋ͡m ˨˩˦
khớp	kʰ əː p̚ ˦˥
khờ	kʰ əː ˨˩
khủng	kʰ ʊ w ŋ͡m ˨˩˦
khứa	kʰ ɨ ə ˦˥
khứng	kʰ ɨ ŋ ˦˥
khử	kʰ ɨ ˨˩˦
khựa	kʰ ɨ ə ˨˩˨
khựng	kʰ ɨ ŋ ˨˩˨
ki	k ɪ j ˧˧
kia	k i ə ˧˧
kilôgam	k ɪ j ˧˧ l o w ˧˧ ɣ aː m ˧˧
kilômet	k ɪ j ˧˧ l o w ˧˧ m ɛ k̚ ˦˥
kilômét	k ɪ j ˧˧ l o w ˧˧ m ɛ k̚ ˦˥
kilôoat	k ɪ j ˧˧ l o w ˧˧ ʔ w aː k̚ ˦˥
kim	k i m ˧˧
kinh	k ɨ n ˧˧
kirixitô	k ɪ j ˧˧ ɹ ɪ j ˧˧ s ɪ j ˧˧ t o w ˧˧
kiêm	k i m ˧˧
kiên	k i ə ŋ ˧˧
kiêng	k i ə ŋ ˧˧
kiêu	k i w ˧˧
kiếm	k i m ˦˥
kiến	k i ə ŋ ˦˥
kiếng	k i ə ŋ ˦˥
kiếp	k i p̚ ˦˥
kiết	k i ə k̚ ˦˥
kiếu	k i w ˦˥
kiềm	k i m ˨˩
kiều	k i w ˨˩
kiểm	k i m ˨˩˦
kiểng	k i ə ŋ ˨˩˦
kiểu	k i w ˨˩˦
kiện	k i ə ŋ ˨˩˨
kiệt	k i ə k̚ ˨˩˨
kiệu	k i w ˨˩˨
koala	k o w ˧˧ ʔ aː ˧˧ l aː ˧˧
kripton	k ɹ i p̚ ˦˥ t ə w ŋ͡m ˧˧
kute	k ʊ w ˧˧ t ɛ ˧˧
kè	k ɛ ˨˩
kèm	k ɛ m ˨˩
kèn	k ɛ ŋ ˨˩
kèo	k ɛ w ˨˩
ké	k ɛ ˦˥
kém	k ɛ m ˦˥
kén	k ɛ ŋ ˦˥
kéo	k ɛ w ˦˥
kép	k ɛ p̚ ˦˥
két	k ɛ k̚ ˦˥
kê	k e j ˧˧
kênh	k əː n ˧˧
kêu	k e w ˧˧
kì	k ɪ j ˨˩
kìa	k i ə ˨˩
kìm	k i m ˨˩
kình	k ɨ n ˨˩
kí	k ɪ j ˦˥
kích	k ɨ t̚ ˦˥
kín	k ɨ n ˦˥
kính	k ɨ n ˦˥
kíp	k i p̚ ˦˥
kĩ	k ɪ j ˨˩˦
kẹc	k ɛ k̚ ˨˩˨
kẹo	k ɛ w ˨˩˨
kẹp	k ɛ p̚ ˨˩˨
kẹt	k ɛ k̚ ˨˩˨
kẻ	k ɛ ˨˩˦
kẻng	k ɛ ŋ ˨˩˦
kẻo	k ɛ w ˨˩˦
kẽ	k ɛ ˨˩˦
kẽm	k ɛ m ˨˩˦
kế	k e j ˦˥
kếch	k əː t̚ ˦˥
kết	k əː t̚ ˦˥
kề	k e j ˨˩
kền	k əː n ˨˩
kềnh	k əː n ˨˩
kể	k e j ˨˩˦
kệ	k e j ˨˩˨
kệch	k əː t̚ ˨˩˨
kỉ	k ɪ j ˨˩˦
kịch	k ɨ t̚ ˨˩˨
kịp	k i p̚ ˨˩˨
l	ʔ ɛ ˧˧ l əː ˨˩
la	l aː ˧˧
lai	l aː j ˧˧
lam	l aː m ˧˧
lan	l aː ŋ ˧˧
lang	l aː ŋ ˧˧
lanh	l a n ˧˧
lantan	l aː n ˧˧ t aː n ˧˧
lao	l aː w ˧˧
latinh	l aː ˧˧ t ɨ n ˧˧
lau	l aː w ˧˧
lay	l aː j ˧˧
le	l ɛ ˧˧
lem	l ɛ m ˧˧
len	l ɛ ŋ ˧˧
leo	l ɛ w ˧˧
li	l ɪ j ˧˧
lia	l i ə ˧˧
lim	l i m ˧˧
linh	l ɨ n ˧˧
linô	l ɨ n ˧˧ n o w ˧˧
liti	l ɪ j ˧˧ t ɪ j ˧˧
livermori	l ɪ j ˧˧ v əː ˧˧ m ɔ ˧˧ ɹ ɪ j ˧˧
liêm	l i m ˧˧
liên	l i ə ŋ ˧˧
liếc	l i ə k̚ ˦˥
liếm	l i m ˦˥
liềm	l i m ˨˩
liền	l i ə ŋ ˨˩
liều	l i w ˨˩
liễu	l i w ˨˩˦
liệng	l i ə ŋ ˨˩˨
liệt	l i ə k̚ ˨˩˨
liệu	l i w ˨˩˨
lo	l ɔ ˧˧
loa	l ⁽ʷ ⁾ aː ˧˧
loan	l ⁽ʷ ⁾ aː ŋ ˧˧
loang	l ⁽ʷ ⁾ aː ŋ ˧˧
lon	l ɔ ŋ ˧˧
long	l a w ŋ͡m ˧˧
lorenxi	l ɔ ˧˧ ɹ ɛ ŋ ˧˧ s ɪ j ˧˧
loài	l ⁽ʷ ⁾ aː j ˨˩
loá	l ⁽ʷ ⁾ aː ˦˥
loán	l ⁽ʷ ⁾ aː ŋ ˦˥
loãng	l ⁽ʷ ⁾ aː ŋ ˨˩˦
loè	l ⁽ʷ ⁾ ɛ ˨˩
loé	l ⁽ʷ ⁾ ɛ ˦˥
loét	l ⁽ʷ ⁾ ɛ k̚ ˦˥
loại	l ⁽ʷ ⁾ aː j ˨˩˨
loạn	l ⁽ʷ ⁾ aː ŋ ˨˩˨
loạt	l ⁽ʷ ⁾ aː k̚ ˨˩˨
lu	l ʊ w ˧˧
luca	l ʊ w ˧˧ k aː ˧˧
luciô	l ʊ w ˧˧ s ɪ j ˧˧ ʔ o w ˧˧
lui	l u j ˧˧
lung	l ʊ w ŋ͡m ˧˧
lutexi	l ʊ w ˧˧ t e j ˧˧ s ɪ j ˧˧
luyến	l ⁽ʷ ⁾ i ə ŋ ˦˥
luyện	l ⁽ʷ ⁾ i ə ŋ ˨˩˨
luân	l ⁽ʷ ⁾ ə ŋ ˧˧
luôn	l u ə ŋ ˧˧
luận	l ⁽ʷ ⁾ ə ŋ ˨˩˨
luật	l ⁽ʷ ⁾ ə k̚ ˨˩˨
luốc	l u ə k̚ ˦˥
luống	l u ə ŋ ˦˥
luồn	l u ə ŋ ˨˩
luồng	l u ə ŋ ˨˩
luộc	l u ə k̚ ˨˩˨
luỹ	l ⁽ʷ ⁾ ɪ j ˨˩˦
là	l aː ˨˩
lài	l aː j ˨˩
làm	l aː m ˨˩
làn	l aː ŋ ˨˩
làng	l aː ŋ ˨˩
lành	l a n ˨˩
lào	l aː w ˨˩
lá	l aː ˦˥
lác	l aː k̚ ˦˥
lách	l a t̚ ˦˥
lái	l aː j ˦˥
lán	l aː ŋ ˦˥
láng	l aː ŋ ˦˥
lánh	l a n ˦˥
láo	l aː w ˦˥
lát	l aː k̚ ˦˥
láy	l aː j ˦˥
lâm	l ə m ˧˧
lân	l ə ŋ ˧˧
lâu	l ə w ˧˧
lây	l ə j ˧˧
lãi	l aː j ˨˩˦
lãng	l aː ŋ ˨˩˦
lãnh	l a n ˨˩˦
lão	l aː w ˨˩˦
lè	l ɛ ˨˩
lé	l ɛ ˦˥
lén	l ɛ ŋ ˦˥
lép	l ɛ p̚ ˦˥
lê	l e j ˧˧
lên	l əː n ˧˧
lêô	l e j ˧˧ ʔ o w ˧˧
lì	l ɪ j ˨˩
lìa	l i ə ˨˩
lìn	l ɨ n ˨˩
lí	l ɪ j ˦˥
lính	l ɨ n ˦˥
líp	l i p̚ ˦˥
lít	l ɨ t̚ ˦˥
lò	l ɔ ˨˩
lòi	l ɔ j ˨˩
lòn	l ɔ ŋ ˨˩
lòng	l a w ŋ͡m ˨˩
ló	l ɔ ˦˥
lóc	l a w k͡p̚ ˦˥
lóng	l a w ŋ͡m ˦˥
lót	l ɔ k̚ ˦˥
lôgarit	l o w ˧˧ ɣ aː ˧˧ ɹ ɨ t̚ ˧˧
lôgic	l o w ˧˧ j ɨ t̚ ˦˥
lôi	l o j ˧˧
lông	l ə w ŋ͡m ˧˧
lôrensô	l o w ˧˧ ɹ ɛ ŋ ˧˧ ʂ o w ˧˧
lõ	l ɔ ˨˩˦
lõi	l ɔ j ˨˩˦
lõm	l ɔ m ˨˩˦
lõng	l a w ŋ͡m ˨˩˦
lùa	l u ə ˨˩
lùi	l u j ˨˩
lùm	l ʊ m ˨˩
lùn	l ʊ w ŋ͡m ˨˩
lùng	l ʊ w ŋ͡m ˨˩
lú	l ʊ w ˦˥
lúa	l u ə ˦˥
lúc	l ʊ w k͡p̚ ˦˥
lún	l ʊ w ŋ͡m ˦˥
lăm	l a m ˧˧
lăn	l a ŋ ˧˧
lăng	l a ŋ ˧˧
lĩnh	l ɨ n ˨˩˦
lũ	l ʊ w ˨˩˦
lơ	l əː ˧˧
lơi	l əː j ˧˧
lưng	l ɨ ŋ ˧˧
lưu	l ɨ w ˧˧
lươn	l ɨ ə ŋ ˧˧
lương	l ɨ ə ŋ ˧˧
lưới	l ɨ j ˦˥
lướt	l ɨ ə k̚ ˦˥
lười	l ɨ j ˨˩
lườm	l ɨ ə m ˨˩
lườn	l ɨ ə ŋ ˨˩
lường	l ɨ ə ŋ ˨˩
lưỡi	l ɨ j ˨˩˦
lược	l ɨ ə k̚ ˨˩˨
lượm	l ɨ ə m ˨˩˨
lượn	l ɨ ə ŋ ˨˩˨
lượng	l ɨ ə ŋ ˨˩˨
lượt	l ɨ ə k̚ ˨˩˨
lạ	l aː ˨˩˨
lạc	l aː k̚ ˨˩˨
lạch	l a t̚ ˨˩˨
lại	l aː j ˨˩˨
lạng	l aː ŋ ˨˩˨
lạnh	l a n ˨˩˨
lạt	l aː k̚ ˨˩˨
lạy	l aː j ˨˩˨
lảng	l aː ŋ ˨˩˦
lấm	l ə m ˦˥
lấn	l ə ŋ ˦˥
lấp	l ə p̚ ˦˥
lấy	l ə j ˦˥
lầm	l ə m ˨˩
lần	l ə ŋ ˨˩
lầu	l ə w ˨˩
lầy	l ə j ˨˩
lẩn	l ə ŋ ˨˩˦
lẩu	l ə w ˨˩˦
lẫn	l ə ŋ ˨˩˦
lẫy	l ə j ˨˩˦
lận	l ə ŋ ˨˩˨
lập	l ə p̚ ˨˩˨
lật	l ə k̚ ˨˩˨
lậu	l ə w ˨˩˨
lắc	l a k̚ ˦˥
lắm	l a m ˦˥
lắng	l a ŋ ˦˥
lắp	l a p̚ ˦˥
lằn	l a ŋ ˨˩
lẵng	l a ŋ ˨˩˦
lặn	l a ŋ ˨˩˨
lặng	l a ŋ ˨˩˨
lặp	l a p̚ ˨˩˨
lặt	l a k̚ ˨˩˨
lẹ	l ɛ ˨˩˨
lẹo	l ɛ w ˨˩˨
lẻ	l ɛ ˨˩˦
lẻn	l ɛ ŋ ˨˩˦
lẽ	l ɛ ˨˩˦
lết	l əː t̚ ˦˥
lề	l e j ˨˩
lều	l e w ˨˩
lễ	l e j ˨˩˦
lệ	l e j ˨˩˨
lệch	l əː t̚ ˨˩˨
lệnh	l əː n ˨˩˨
lị	l ɪ j ˨˩˨
lịch	l ɨ t̚ ˨˩˨
lịm	l i m ˨˩˨
lọ	l ɔ ˨˩˨
lọc	l a w k͡p̚ ˨˩˨
lọn	l ɔ ŋ ˨˩˨
lọt	l ɔ k̚ ˨˩˨
lỏm	l ɔ m ˨˩˦
lỏng	l a w ŋ͡m ˨˩˦
lố	l o w ˦˥
lốc	l ə w k͡p̚ ˦˥
lối	l o j ˦˥
lốp	l o p̚ ˦˥
lốt	l o k̚ ˦˥
lồi	l o j ˨˩
lồn	l o ŋ ˨˩
lồng	l ə w ŋ͡m ˨˩
lỗ	l o w ˨˩˦
lỗi	l o j ˨˩˦
lộ	l o w ˨˩˨
lộc	l ə w k͡p̚ ˨˩˨
lội	l o j ˨˩˨
lộn	l o ŋ ˨˩˨
lộng	l ə w ŋ͡m ˨˩˨
lột	l o k̚ ˨˩˨
lớn	l əː ŋ ˦˥
lớp	l əː p̚ ˦˥
lờ	l əː ˨˩
lời	l əː j ˨˩
lờn	l əː ŋ ˨˩
lở	l əː ˨˩˦
lỡ	l əː ˨˩˦
lợi	l əː j ˨˩˨
lợn	l əː ŋ ˨˩˨
lợp	l əː p̚ ˨˩˨
lụa	l u ə ˨˩˨
lục	l ʊ w k͡p̚ ˨˩˨
lụm	l ʊ m ˨˩˨
lụt	l ʊ k͡p̚ ˨˩˨
lủng	l ʊ w ŋ͡m ˨˩˦
lứa	l ɨ ə ˦˥
lừa	l ɨ ə ˨˩
lừng	l ɨ ŋ ˨˩
lửa	l ɨ ə ˨˩˦
lửng	l ɨ ŋ ˨˩˦
lự	l ɨ ˨˩˨
lựa	l ɨ ə ˨˩˨
lực	l ɨ k̚ ˨˩˨
lựu	l ɨ w ˨˩˨
m	ʔ ɛ ˧˧ m əː ˨˩
m'nông	m əː ˧˧ n ə w ŋ͡m ˧˧
ma	m aː ˧˧
magie	m aː ˧˧ j e j ˧˧
mai	m aː j ˧˧
man	m aː ŋ ˧˧
mang	m aː ŋ ˧˧
mangan	m aː ŋ ˧˧ ɣ aː ŋ ˧˧
manh	m a n ˧˧
maria	m aː ˧˧ ɹ ɪ j ˧˧ ʔ aː ˧˧
maroc	m aː ˧˧ ɹ ə w k͡p̚ ˦˥
martinô	m aː ˧˧ t ɨ n ˧˧ n o w ˧˧
mau	m aː w ˧˧
may	m aː j ˧˧
mc	ʔ ɛ m ˧˧ s ɪ j ˧˧
me	m ɛ ˧˧
men	m ɛ ŋ ˧˧
menđelevi	m ɛ ŋ ˧˧ ʔ ɗ e j ˧˧ l e j ˧˧ v ɪ j ˧˧
meo	m ɛ w ˧˧
mi	m ɪ j ˧˧
micae	m ɪ j ˧˧ k aː ˧˧ ʔ ɛ ˧˧
min	m ɨ n ˧˧
minh	m ɨ n ˧˧
miu	m i w ˧˧
miên	m i ə ŋ ˧˧
miến	m i ə ŋ ˦˥
miếng	m i ə ŋ ˦˥
miếu	m i w ˦˥
miền	m i ə ŋ ˨˩
miểng	m i ə ŋ ˨˩˦
miễn	m i ə ŋ ˨˩˦
miệng	m i ə ŋ ˨˩˨
mo	m ɔ ˧˧
moa	m w aː ˧˧
modem	m o w ˧˧ ʔ ɗ e m ˧˧
moi	m ɔ j ˧˧
mol	m ɔ ŋ ˧˧
molipđen	m o w ˧˧ l i p̚ ˦˥ ʔ ɗ ɛ ŋ ˧˧
mong	m a w ŋ͡m ˧˧
moóc	m ɔ k̚ ˦˥
moạ	m w aː ˨˩˨
moả	m w aː ˨˩˦
mtdtgpmnvn	m a k̚ ˨˩˨ ʈ ə ŋ ˨˩˨ j ə ŋ ˧˧ t ə w k͡p̚ ˨˩˨ j aː j ˨˩˦ f a w ŋ͡m ˦˥ m i ə ŋ ˨˩ n aː m ˧˧ v i ə k̚ ˨˩˨ n aː m ˧˧
mu	m ʊ w ˧˧
mua	m u ə ˧˧
mui	m u j ˧˧
mun	m ʊ w ŋ͡m ˧˧
muôi	m u j ˧˧
muôn	m u ə ŋ ˧˧
muông	m u ə ŋ ˧˧
muối	m u j ˦˥
muốn	m u ə ŋ ˦˥
muống	m u ə ŋ ˦˥
muỗi	m u j ˨˩˦
muỗng	m u ə ŋ ˨˩˦
muội	m u j ˨˩˨
muộn	m u ə ŋ ˨˩˨
mà	m aː ˨˩
mài	m aː j ˨˩
màn	m aː ŋ ˨˩
màng	m aː ŋ ˨˩
mào	m aː w ˨˩
màu	m aː w ˨˩
mày	m aː j ˨˩
má	m aː ˦˥
mác	m aː k̚ ˦˥
máccô	m aː k̚ ˦˥ k o w ˧˧
mách	m a t̚ ˦˥
máctinô	m aː k̚ ˦˥ t ɪ j ˧˧ n o w ˧˧
mái	m aː j ˦˥
máng	m aː ŋ ˦˥
mánh	m a n ˦˥
mát	m aː k̚ ˦˥
mátthêu	m aː k̚ ˦˥ tʰ e w ˧˧
máu	m aː w ˦˥
máy	m aː j ˦˥
mâm	m ə m ˧˧
mân	m ə ŋ ˧˧
mây	m ə j ˧˧
mã	m aː ˨˩˦
mãi	m aː j ˨˩˦
mãn	m aː ŋ ˨˩˦
mão	m aː w ˨˩˦
mè	m ɛ ˨˩
mèm	m ɛ m ˨˩
mèo	m ɛ w ˨˩
mé	m ɛ ˦˥
méc	m ɛ k̚ ˦˥
mén	m ɛ ŋ ˦˥
méo	m ɛ w ˦˥
mép	m ɛ p̚ ˦˥
mét	m ɛ k̚ ˦˥
mê	m e j ˧˧
mì	m ɪ j ˨˩
mìn	m ɨ n ˨˩
mình	m ɨ n ˨˩
mí	m ɪ j ˦˥
mía	m i ə ˦˥
mím	m i m ˦˥
mít	m ɨ t̚ ˦˥
mò	m ɔ ˨˩
mòn	m ɔ ŋ ˨˩
mòng	m a w ŋ͡m ˨˩
mó	m ɔ ˦˥
móc	m a w k͡p̚ ˦˥
móm	m ɔ m ˦˥
món	m ɔ ŋ ˦˥
móng	m a w ŋ͡m ˦˥
móp	m ɔ p̚ ˦˥
mót	m ɔ k̚ ˦˥
mô	m o w ˧˧
môi	m o j ˧˧
môn	m o ŋ ˧˧
mông	m ə w ŋ͡m ˧˧
mônica	m o ŋ ˧˧ n ɪ j ˧˧ k aː ˧˧
mõ	m ɔ ˨˩˦
mõm	m ɔ m ˨˩˦
mù	m ʊ w ˨˩
mùa	m u ə ˨˩
mùi	m u j ˨˩
mùn	m ʊ w ŋ͡m ˨˩
mùng	m ʊ w ŋ͡m ˨˩
múa	m u ə ˦˥
múc	m ʊ w k͡p̚ ˦˥
múi	m u j ˦˥
múp	m ʊ p̚ ˦˥
mút	m ʊ k͡p̚ ˦˥
măm	m a m ˧˧
măng	m a ŋ ˧˧
mĩ	m ɪ j ˨˩˦
mũ	m ʊ w ˨˩˦
mũi	m u j ˨˩˦
mơ	m əː ˧˧
mưa	m ɨ ə ˧˧
mưu	m ɨ w ˧˧
mươi	m ɨ j ˧˧
mương	m ɨ ə ŋ ˧˧
mướn	m ɨ ə ŋ ˦˥
mướp	m ɨ ə p̚ ˦˥
mướt	m ɨ ə k̚ ˦˥
mười	m ɨ j ˨˩
mường	m ɨ ə ŋ ˨˩
mượn	m ɨ ə ŋ ˨˩˨
mượt	m ɨ ə k̚ ˨˩˨
mạ	m aː ˨˩˨
mạc	m aː k̚ ˨˩˨
mạch	m a t̚ ˨˩˨
mạn	m aː ŋ ˨˩˨
mạng	m aː ŋ ˨˩˨
mạnh	m a n ˨˩˨
mạo	m aː w ˨˩˨
mạt	m aː k̚ ˨˩˨
mả	m aː ˨˩˦
mải	m aː j ˨˩˦
mảng	m aː ŋ ˨˩˦
mảnh	m a n ˨˩˦
mấn	m ə ŋ ˦˥
mất	m ə k̚ ˦˥
mấu	m ə w ˦˥
mấy	m ə j ˦˥
mầm	m ə m ˨˩
mần	m ə ŋ ˨˩
mầu	m ə w ˨˩
mầy	m ə j ˨˩
mẩu	m ə w ˨˩˦
mẩy	m ə j ˨˩˦
mẫn	m ə ŋ ˨˩˦
mẫu	m ə w ˨˩˦
mận	m ə ŋ ˨˩˨
mập	m ə p̚ ˨˩˨
mật	m ə k̚ ˨˩˨
mậu	m ə w ˨˩˨
mắc	m a k̚ ˦˥
mắm	m a m ˦˥
mắn	m a ŋ ˦˥
mắng	m a ŋ ˦˥
mắt	m a k̚ ˦˥
mặc	m a k̚ ˨˩˨
mặn	m a ŋ ˨˩˨
mặt	m a k̚ ˨˩˨
mẹ	m ɛ ˨˩˨
mẹo	m ɛ w ˨˩˨
mẻ	m ɛ ˨˩˦
mẽ	m ɛ ˨˩˦
mến	m əː n ˦˥
mếu	m e w ˦˥
mề	m e j ˨˩
mềm	m e m ˨˩
mền	m əː n ˨˩
mễ	m e j ˨˩˦
mệ	m e j ˨˩˨
mệnh	m əː n ˨˩˨
mệt	m əː t̚ ˨˩˨
mỉa	m i ə ˨˩˦
mỉm	m i m ˨˩˦
mịn	m ɨ n ˨˩˨
mịt	m ɨ t̚ ˨˩˨
mọc	m a w k͡p̚ ˨˩˨
mọi	m ɔ j ˨˩˨
mọn	m ɔ ŋ ˨˩˨
mọng	m a w ŋ͡m ˨˩˨
mọt	m ɔ k̚ ˨˩˨
mỏ	m ɔ ˨˩˦
mỏi	m ɔ j ˨˩˦
mỏng	m a w ŋ͡m ˨˩˦
mốc	m ə w k͡p̚ ˦˥
mối	m o j ˦˥
mống	m ə w ŋ͡m ˦˥
mốt	m o k̚ ˦˥
mồ	m o w ˨˩
mồi	m o j ˨˩
mồm	m o m ˨˩
mồng	m ə w ŋ͡m ˨˩
mổ	m o w ˨˩˦
mỗi	m o j ˨˩˦
mộ	m o w ˨˩˨
mộc	m ə w k͡p̚ ˨˩˨
mộng	m ə w ŋ͡m ˨˩˨
một	m o k̚ ˨˩˨
mớ	m əː ˦˥
mới	m əː j ˦˥
mớm	m əː m ˦˥
mờ	m əː ˨˩
mời	m əː j ˨˩
mở	m əː ˨˩˦
mỡ	m əː ˨˩˦
mợ	m əː ˨˩˨
mụ	m ʊ w ˨˩˨
mục	m ʊ w k͡p̚ ˨˩˨
mụn	m ʊ w ŋ͡m ˨˩˨
mụp	m ʊ p̚ ˨˩˨
mụt	m ʊ k͡p̚ ˨˩˨
mủ	m ʊ w ˨˩˦
mủi	m u j ˨˩˦
mủn	m ʊ w ŋ͡m ˨˩˦
mứa	m ɨ ə ˦˥
mức	m ɨ k̚ ˦˥
mứt	m ɨ k̚ ˦˥
mừng	m ɨ ŋ ˨˩
mửa	m ɨ ə ˨˩˦
mực	m ɨ k̚ ˨˩˨
n	ʔ ɛ ˧˧ n əː ˨˩
na	n aː ˧˧
nai	n aː j ˧˧
nam	n aː m ˧˧
nan	n aː ŋ ˧˧
nang	n aː ŋ ˧˧
nanh	n a n ˧˧
nao	n aː w ˧˧
napan	n aː ˧˧ p aː ŋ ˧˧
natri	n aː ˧˧ ʈ ɪ j ˧˧
nay	n aː j ˧˧
nem	n ɛ m ˧˧
neo	n ɛ w ˧˧
neon	n e j ˧˧ ʔ ə w ŋ͡m ˧˧
neođim	n e j ˧˧ ʔ o w ˧˧ ʔ ɗ i m ˧˧
nga	ŋ aː ˧˧
ngai	ŋ aː j ˧˧
ngan	ŋ aː ŋ ˧˧
ngang	ŋ aː ŋ ˧˧
ngao	ŋ aː w ˧˧
ngay	ŋ aː j ˧˧
nghe	ŋ ɛ ˧˧
nghen	ŋ ɛ ŋ ˧˧
nghi	ŋ ɪ j ˧˧
nghiêm	ŋ i m ˧˧
nghiên	ŋ i ə ŋ ˧˧
nghiêng	ŋ i ə ŋ ˧˧
nghiến	ŋ i ə ŋ ˦˥
nghiền	ŋ i ə ŋ ˨˩
nghiệm	ŋ i m ˨˩˨
nghiện	ŋ i ə ŋ ˨˩˨
nghiệp	ŋ i p̚ ˨˩˨
nghiệt	ŋ i ə k̚ ˨˩˨
nghèo	ŋ ɛ w ˨˩
nghé	ŋ ɛ ˦˥
nghén	ŋ ɛ ŋ ˦˥
nghê	ŋ e j ˧˧
nghênh	ŋ əː n ˧˧
nghêu	ŋ e w ˧˧
nghìm	ŋ i m ˨˩
nghìn	ŋ ɨ n ˨˩
nghía	ŋ i ə ˦˥
nghĩ	ŋ ɪ j ˨˩˦
nghĩa	ŋ i ə ˨˩˦
nghẹ	ŋ ɛ ˨˩˨
nghẹn	ŋ ɛ ŋ ˨˩˨
nghẹo	ŋ ɛ w ˨˩˨
nghẹt	ŋ ɛ k̚ ˨˩˨
nghẽn	ŋ ɛ ŋ ˨˩˦
nghếch	ŋ əː t̚ ˦˥
nghề	ŋ e j ˨˩
nghệ	ŋ e j ˨˩˨
nghỉ	ŋ ɪ j ˨˩˦
nghị	ŋ ɪ j ˨˩˨
nghịch	ŋ ɨ t̚ ˨˩˨
nghịt	ŋ ɨ t̚ ˨˩˨
ngoa	ŋ w aː ˧˧
ngoan	ŋ w aː ŋ ˧˧
ngoi	ŋ ɔ j ˧˧
ngon	ŋ ɔ ŋ ˧˧
ngoài	ŋ w aː j ˨˩
ngoái	ŋ w aː j ˦˥
ngoáy	ŋ w a j ˦˥
ngoé	ŋ w ɛ ˦˥
ngoém	ŋ w ɛ m ˦˥
ngoại	ŋ w aː j ˨˩˨
ngoạm	ŋ w aː m ˨˩˨
ngoải	ŋ w aː j ˨˩˦
ngoảnh	ŋ w a n ˨˩˦
ngoảy	ŋ w a j ˨˩˦
ngoắc	ŋ w a k̚ ˦˥
ngoắt	ŋ w a k̚ ˦˥
ngoặc	ŋ w a k̚ ˨˩˨
ngoặt	ŋ w a k̚ ˨˩˨
ngoẹo	ŋ w ɛ w ˨˩˨
ngu	ŋ ʊ w ˧˧
nguy	ŋ w ɪ j ˧˧
nguyên	ŋ w i ə ŋ ˧˧
nguyền	ŋ w i ə ŋ ˨˩
nguyễn	ŋ w i ə ŋ ˨˩˦
nguyện	ŋ w i ə ŋ ˨˩˨
nguyệt	ŋ w i ə k̚ ˨˩˨
nguôi	ŋ u j ˧˧
nguồn	ŋ u ə ŋ ˨˩
nguội	ŋ u j ˨˩˨
nguỵ	ŋ w ɪ j ˨˩˨
ngà	ŋ aː ˨˩
ngài	ŋ aː j ˨˩
ngàn	ŋ aː ŋ ˨˩
ngành	ŋ a n ˨˩
ngày	ŋ aː j ˨˩
ngách	ŋ a t̚ ˦˥
ngái	ŋ aː j ˦˥
ngám	ŋ aː m ˦˥
ngán	ŋ aː ŋ ˦˥
ngáo	ŋ aː w ˦˥
ngáp	ŋ aː p̚ ˦˥
ngát	ŋ aː k̚ ˦˥
ngáy	ŋ aː j ˦˥
ngâm	ŋ ə m ˧˧
ngân	ŋ ə ŋ ˧˧
ngâu	ŋ ə w ˧˧
ngây	ŋ ə j ˧˧
ngã	ŋ aː ˨˩˦
ngãi	ŋ aː j ˨˩˦
ngò	ŋ ɔ ˨˩
ngòi	ŋ ɔ j ˨˩
ngó	ŋ ɔ ˦˥
ngóc	ŋ a w k͡p̚ ˦˥
ngói	ŋ ɔ j ˦˥
ngón	ŋ ɔ ŋ ˦˥
ngóng	ŋ a w ŋ͡m ˦˥
ngót	ŋ ɔ k̚ ˦˥
ngô	ŋ o w ˧˧
ngôi	ŋ o j ˧˧
ngôn	ŋ o ŋ ˧˧
ngông	ŋ ə w ŋ͡m ˧˧
ngõ	ŋ ɔ ˨˩˦
ngõi	ŋ ɔ j ˨˩˦
ngù	ŋ ʊ w ˨˩
ngùi	ŋ u j ˨˩
ngăm	ŋ a m ˧˧
ngăn	ŋ a ŋ ˧˧
ngũ	ŋ ʊ w ˨˩˦
ngơi	ŋ əː j ˧˧
ngư	ŋ ɨ ˧˧
ngưng	ŋ ɨ ŋ ˧˧
ngươi	ŋ ɨ j ˧˧
ngước	ŋ ɨ ə k̚ ˦˥
người	ŋ ɨ j ˨˩
ngưỡng	ŋ ɨ ə ŋ ˨˩˦
ngược	ŋ ɨ ə k̚ ˨˩˨
ngượng	ŋ ɨ ə ŋ ˨˩˨
ngại	ŋ aː j ˨˩˨
ngạo	ŋ aː w ˨˩˨
ngạt	ŋ aː k̚ ˨˩˨
ngả	ŋ aː ˨˩˦
ngấm	ŋ ə m ˦˥
ngấn	ŋ ə ŋ ˦˥
ngất	ŋ ə k̚ ˦˥
ngấy	ŋ ə j ˦˥
ngầm	ŋ ə m ˨˩
ngần	ŋ ə ŋ ˨˩
ngầu	ŋ ə w ˨˩
ngẩn	ŋ ə ŋ ˨˩˦
ngẩng	ŋ ə ŋ ˨˩˦
ngẫm	ŋ ə m ˨˩˦
ngậm	ŋ ə m ˨˩˨
ngập	ŋ ə p̚ ˨˩˨
ngậy	ŋ ə j ˨˩˨
ngắm	ŋ a m ˦˥
ngắn	ŋ a ŋ ˦˥
ngắt	ŋ a k̚ ˦˥
ngặt	ŋ a k̚ ˨˩˨
ngọ	ŋ ɔ ˨˩˨
ngọc	ŋ a w k͡p̚ ˨˩˨
ngọn	ŋ ɔ ŋ ˨˩˨
ngọng	ŋ a w ŋ͡m ˨˩˨
ngọt	ŋ ɔ k̚ ˨˩˨
ngỏ	ŋ ɔ ˨˩˦
ngố	ŋ o w ˦˥
ngốc	ŋ ə w k͡p̚ ˦˥
ngốn	ŋ o ŋ ˦˥
ngồi	ŋ o j ˨˩
ngỗng	ŋ ə w ŋ͡m ˨˩˦
ngộ	ŋ o w ˨˩˨
ngộp	ŋ o p̚ ˨˩˨
ngột	ŋ o k̚ ˨˩˨
ngớ	ŋ əː ˦˥
ngớp	ŋ əː p̚ ˦˥
ngớt	ŋ əː k̚ ˦˥
ngờ	ŋ əː ˨˩
ngời	ŋ əː j ˨˩
ngỡ	ŋ əː ˨˩˦
ngợi	ŋ əː j ˨˩˨
ngợm	ŋ əː m ˨˩˨
ngợp	ŋ əː p̚ ˨˩˨
ngụ	ŋ ʊ w ˨˩˨
ngục	ŋ ʊ w k͡p̚ ˨˩˨
ngụm	ŋ ʊ m ˨˩˨
ngụp	ŋ ʊ p̚ ˨˩˨
ngủ	ŋ ʊ w ˨˩˦
ngủm	ŋ ʊ m ˨˩˦
ngứa	ŋ ɨ ə ˦˥
ngừa	ŋ ɨ ə ˨˩
ngừng	ŋ ɨ ŋ ˨˩
ngửa	ŋ ɨ ə ˨˩˦
ngửi	ŋ ɨ j ˨˩˦
ngữ	ŋ ɨ ˨˩˦
ngự	ŋ ɨ ˨˩˨
ngựa	ŋ ɨ ə ˨˩˨
ngực	ŋ ɨ k̚ ˨˩˨
nha	ɲ aː ˧˧
nhai	ɲ aː j ˧˧
nhang	ɲ aː ŋ ˧˧
nhanh	ɲ a n ˧˧
nhau	ɲ aː w ˧˧
nhe	ɲ ɛ ˧˧
nheo	ɲ ɛ w ˧˧
nhi	ɲ ɪ j ˧˧
nhiêu	ɲ i w ˧˧
nhiếc	ɲ i ə k̚ ˦˥
nhiều	ɲ i w ˨˩
nhiễm	ɲ i m ˨˩˦
nhiễu	ɲ i w ˨˩˦
nhiệt	ɲ i ə k̚ ˨˩˨
nho	ɲ ɔ ˧˧
nhoi	ɲ ɔ j ˧˧
nhoà	ɲ w aː ˨˩
nhoáng	ɲ w aː ŋ ˦˥
nhoẻn	ɲ w ɛ ŋ ˨˩˦
nhu	ɲ ʊ w ˧˧
nhung	ɲ ʊ w ŋ͡m ˧˧
nhuyễn	ɲ w i ə ŋ ˨˩˦
nhuốm	ɲ u ə m ˦˥
nhuộm	ɲ u ə m ˨˩˨
nhuỵ	ɲ w ɪ j ˨˩˨
nhà	ɲ aː ˨˩
nhài	ɲ aː j ˨˩
nhàm	ɲ aː m ˨˩
nhàn	ɲ aː ŋ ˨˩
nhào	ɲ aː w ˨˩
nhàu	ɲ aː w ˨˩
nhá	ɲ aː ˦˥
nhác	ɲ aː k̚ ˦˥
nhách	ɲ a t̚ ˦˥
nhái	ɲ aː j ˦˥
nhám	ɲ aː m ˦˥
nhánh	ɲ a n ˦˥
nháo	ɲ aː w ˦˥
nháp	ɲ aː p̚ ˦˥
nhát	ɲ aː k̚ ˦˥
nháy	ɲ aː j ˦˥
nhâm	ɲ ə m ˧˧
nhân	ɲ ə ŋ ˧˧
nhây	ɲ ə j ˧˧
nhã	ɲ aː ˨˩˦
nhãn	ɲ aː ŋ ˨˩˦
nhãng	ɲ aː ŋ ˨˩˦
nhão	ɲ aː w ˨˩˦
nhè	ɲ ɛ ˨˩
nhé	ɲ ɛ ˦˥
nhéo	ɲ ɛ w ˦˥
nhép	ɲ ɛ p̚ ˦˥
nhét	ɲ ɛ k̚ ˦˥
nhì	ɲ ɪ j ˨˩
nhìn	ɲ ɨ n ˨˩
nhí	ɲ ɪ j ˦˥
nhích	ɲ ɨ t̚ ˦˥
nhím	ɲ i m ˦˥
nhíp	ɲ i p̚ ˦˥
nhíu	ɲ i w ˦˥
nhòm	ɲ ɔ m ˨˩
nhóc	ɲ a w k͡p̚ ˦˥
nhói	ɲ ɔ j ˦˥
nhóm	ɲ ɔ m ˦˥
nhón	ɲ ɔ ŋ ˦˥
nhót	ɲ ɔ k̚ ˦˥
nhô	ɲ o w ˧˧
nhôm	ɲ o m ˧˧
nhông	ɲ ə w ŋ͡m ˧˧
nhôông	ɲ o ŋ ˧˧
nhú	ɲ ʊ w ˦˥
nhúm	ɲ ʊ m ˦˥
nhún	ɲ ʊ w ŋ͡m ˦˥
nhúng	ɲ ʊ w ŋ͡m ˦˥
nhăm	ɲ a m ˧˧
nhăn	ɲ a ŋ ˧˧
nhĩ	ɲ ɪ j ˨˩˦
nhũn	ɲ ʊ w ŋ͡m ˨˩˦
nhơ	ɲ əː ˧˧
nhơi	ɲ əː j ˧˧
như	ɲ ɨ ˧˧
nhưng	ɲ ɨ ŋ ˧˧
nhướn	ɲ ɨ ə ŋ ˦˥
nhường	ɲ ɨ ə ŋ ˨˩
nhượng	ɲ ɨ ə ŋ ˨˩˨
nhạc	ɲ aː k̚ ˨˩˨
nhại	ɲ aː j ˨˩˨
nhạn	ɲ aː ŋ ˨˩˨
nhạo	ɲ aː w ˨˩˨
nhạt	ɲ aː k̚ ˨˩˨
nhạy	ɲ aː j ˨˩˨
nhả	ɲ aː ˨˩˦
nhảm	ɲ aː m ˨˩˦
nhảy	ɲ aː j ˨˩˦
nhấc	ɲ ə k̚ ˦˥
nhấm	ɲ ə m ˦˥
nhấn	ɲ ə ŋ ˦˥
nhấp	ɲ ə p̚ ˦˥
nhất	ɲ ə k̚ ˦˥
nhầm	ɲ ə m ˨˩
nhầy	ɲ ə j ˨˩
nhẩm	ɲ ə m ˨˩˦
nhẫn	ɲ ə ŋ ˨˩˦
nhận	ɲ ə ŋ ˨˩˨
nhập	ɲ ə p̚ ˨˩˨
nhật	ɲ ə k̚ ˨˩˨
nhậu	ɲ ə w ˨˩˨
nhắc	ɲ a k̚ ˦˥
nhắm	ɲ a m ˦˥
nhắn	ɲ a ŋ ˦˥
nhắt	ɲ a k̚ ˦˥
nhằm	ɲ a m ˨˩
nhằn	ɲ a ŋ ˨˩
nhẵn	ɲ a ŋ ˨˩˦
nhặng	ɲ a ŋ ˨˩˨
nhặt	ɲ a k̚ ˨˩˨
nhẹ	ɲ ɛ ˨˩˨
nhếch	ɲ əː t̚ ˦˥
nhể	ɲ e j ˨˩˦
nhện	ɲ əː n ˨˩˨
nhỉ	ɲ ɪ j ˨˩˦
nhỉnh	ɲ ɨ n ˨˩˦
nhị	ɲ ɪ j ˨˩˨
nhịn	ɲ ɨ n ˨˩˨
nhịp	ɲ i p̚ ˨˩˨
nhọ	ɲ ɔ ˨˩˨
nhọc	ɲ a w k͡p̚ ˨˩˨
nhọn	ɲ ɔ ŋ ˨˩˨
nhọt	ɲ ɔ k̚ ˨˩˨
nhỏ	ɲ ɔ ˨˩˦
nhỏng	ɲ a w ŋ͡m ˨˩˦
nhốt	ɲ o k̚ ˦˥
nhồi	ɲ o j ˨˩
nhổ	ɲ o w ˨˩˦
nhổm	ɲ o m ˨˩˦
nhộn	ɲ o ŋ ˨˩˨
nhộng	ɲ ə w ŋ͡m ˨˩˨
nhột	ɲ o k̚ ˨˩˨
nhớ	ɲ əː ˦˥
nhớn	ɲ əː ŋ ˦˥
nhớp	ɲ əː p̚ ˦˥
nhớt	ɲ əː k̚ ˦˥
nhờ	ɲ əː ˨˩
nhời	ɲ əː j ˨˩
nhờn	ɲ əː ŋ ˨˩
nhởi	ɲ əː j ˨˩˦
nhỡ	ɲ əː ˨˩˦
nhợn	ɲ əː ŋ ˨˩˨
nhục	ɲ ʊ w k͡p̚ ˨˩˨
nhủ	ɲ ʊ w ˨˩˦
nhủi	ɲ u j ˨˩˦
nhức	ɲ ɨ k̚ ˦˥
nhừ	ɲ ɨ ˨˩
nhử	ɲ ɨ ˨˩˦
những	ɲ ɨ ŋ ˨˩˦
nhựa	ɲ ɨ ə ˨˩˨
ni	n ɪ j ˧˧
niken	n ɪ j ˧˧ k ɛ n ˧˧
ninh	n ɨ n ˧˧
niobi	n ɪ j ˧˧ ʔ o w ˧˧ ʔ ɓ ɪ j ˧˧
nitơ	n ɪ j ˧˧ t əː ˧˧
niên	n i ə ŋ ˧˧
niêu	n i w ˧˧
niềm	n i m ˨˩
niền	n i ə ŋ ˨˩
niềng	n i ə ŋ ˨˩
niễng	n i ə ŋ ˨˩˦
niệt	n i ə k̚ ˨˩˨
no	n ɔ ˧˧
nobeli	n o w ˧˧ ʔ ɓ e j ˧˧ l ɪ j ˧˧
noi	n ɔ j ˧˧
nom	n ɔ m ˧˧
non	n ɔ ŋ ˧˧
nong	n a w ŋ͡m ˧˧
noãn	n w aː ŋ ˨˩˦
nui	n u j ˧˧
nung	n ʊ w ŋ͡m ˧˧
nuy	n w ɪ j ˧˧
nuôi	n u j ˧˧
nuối	n u j ˦˥
nuốt	n u ə k̚ ˦˥
nuột	n u ə k̚ ˨˩˨
nxb	ɲ aː ˨˩ s ⁽ʷ ⁾ ə k̚ ˦˥ ʔ ɓ aː ŋ ˨˩˦
ny	n ɪ j ˧˧
nài	n aː j ˨˩
nàng	n aː ŋ ˨˩
nào	n aː w ˨˩
này	n aː j ˨˩
ná	n aː ˦˥
nách	n a t̚ ˦˥
nái	n aː j ˦˥
nám	n aː m ˦˥
nán	n aː ŋ ˦˥
náng	n aː ŋ ˦˥
nát	n aː k̚ ˦˥
náu	n aː w ˦˥
nâng	n ə ŋ ˧˧
nâu	n ə w ˧˧
nã	n aː ˨˩˦
não	n aː w ˨˩˦
nãy	n aː j ˨˩˦
nè	n ɛ ˨˩
né	n ɛ ˦˥
ném	n ɛ m ˦˥
nén	n ɛ ŋ ˦˥
nép	n ɛ p̚ ˦˥
nét	n ɛ k̚ ˦˥
nê	n e j ˧˧
nêm	n e m ˧˧
nên	n əː n ˧˧
nêu	n e w ˧˧
ních	n ɨ t̚ ˦˥
nín	n ɨ n ˦˥
níu	n i w ˦˥
nòi	n ɔ j ˨˩
nòng	n a w ŋ͡m ˨˩
nó	n ɔ ˦˥
nóc	n a w k͡p̚ ˦˥
nói	n ɔ j ˦˥
nón	n ɔ ŋ ˦˥
nóng	n a w ŋ͡m ˦˥
nôi	n o j ˧˧
nôm	n o m ˧˧
nôn	n o ŋ ˧˧
nông	n ə w ŋ͡m ˧˧
nõ	n ɔ ˨˩˦
nõn	n ɔ ŋ ˨˩˦
nùi	n u j ˨˩
nùng	n ʊ w ŋ͡m ˨˩
núc	n ʊ w k͡p̚ ˦˥
núi	n u j ˦˥
núm	n ʊ m ˦˥
núp	n ʊ p̚ ˦˥
nút	n ʊ k͡p̚ ˦˥
năm	n a m ˧˧
năng	n a ŋ ˧˧
nĩa	n i ə ˨˩˦
nơ	n əː ˧˧
nơi	n əː j ˧˧
nơtron	n əː ˧˧ ʈ ə w ŋ͡m ˧˧
nương	n ɨ ə ŋ ˧˧
nước	n ɨ ə k̚ ˦˥
nướng	n ɨ ə ŋ ˦˥
nướu	n ɨ ə w ˦˥
nạ	n aː ˨˩˨
nạc	n aː k̚ ˨˩˨
nạm	n aː m ˨˩˨
nạn	n aː ŋ ˨˩˨
nạng	n aː ŋ ˨˩˨
nạo	n aː w ˨˩˨
nạp	n aː p̚ ˨˩˨
nạt	n aː k̚ ˨˩˨
nạy	n aː j ˨˩˨
nải	n aː j ˨˩˦
nản	n aː ŋ ˨˩˦
nảy	n aː j ˨˩˦
nấc	n ə k̚ ˦˥
nấm	n ə m ˦˥
nấp	n ə p̚ ˦˥
nấu	n ə w ˦˥
nấy	n ə j ˦˥
nầy	n ə j ˨˩
nẩu	n ə w ˨˩˦
nẫu	n ə w ˨˩˦
nậy	n ə j ˨˩˨
nắm	n a m ˦˥
nắn	n a ŋ ˦˥
nắng	n a ŋ ˦˥
nắp	n a p̚ ˦˥
nằm	n a m ˨˩
nẳm	n a m ˨˩˦
nặc	n a k̚ ˨˩˨
nặn	n a ŋ ˨˩˨
nặng	n a ŋ ˨˩˨
nẹp	n ɛ p̚ ˨˩˨
nẻ	n ɛ ˨˩˦
nẻo	n ɛ w ˨˩˦
nếm	n e m ˦˥
nến	n əː n ˦˥
nếp	n e p̚ ˦˥
nết	n əː t̚ ˦˥
nếu	n e w ˦˥
nền	n əː n ˨˩
nể	n e j ˨˩˦
nệm	n e m ˨˩˨
nện	n əː n ˨˩˨
nịch	n ɨ t̚ ˨˩˨
nịnh	n ɨ n ˨˩˨
nịt	n ɨ t̚ ˨˩˨
nọ	n ɔ ˨˩˨
nọc	n a w k͡p̚ ˨˩˨
nọng	n a w ŋ͡m ˨˩˨
nỏ	n ɔ ˨˩˦
nốc	n ə w k͡p̚ ˦˥
nối	n o j ˦˥
nốt	n o k̚ ˦˥
nồi	n o j ˨˩
nồng	n ə w ŋ͡m ˨˩
nổ	n o w ˨˩˦
nổi	n o j ˨˩˦
nỗi	n o j ˨˩˦
nội	n o j ˨˩˨
nộm	n o m ˨˩˨
nộp	n o p̚ ˨˩˨
nớ	n əː ˦˥
nới	n əː j ˦˥
nở	n əː ˨˩˦
nỡ	n əː ˨˩˦
nợ	n əː ˨˩˨
nụ	n ʊ w ˨˩˨
nứa	n ɨ ə ˦˥
nứng	n ɨ ŋ ˦˥
nứt	n ɨ k̚ ˦˥
nừng	n ɨ ŋ ˨˩
nửa	n ɨ ə ˨˩˦
nữ	n ɨ ˨˩˦
nữa	n ɨ ə ˨˩˦
nực	n ɨ k̚ ˨˩˨
nựng	n ɨ ŋ ˨˩˨
o	ʔ ɔ ˧˧
oai	ʔ w aː j ˧˧
obitan	ʔ ɔ ˧˧ ʔ ɓ ɪ j ˧˧ t aː ŋ ˧˧
oi	ʔ ɔ j ˧˧
om	ʔ ɔ m ˧˧
ong	ʔ a w ŋ͡m ˧˧
osimi	ʔ o w ˧˧ s ɪ j ˧˧ m ɪ j ˧˧
oxi	ʔ o w ˧˧ s ɪ j ˧˧
oà	ʔ w aː ˨˩
oách	ʔ w a t̚ ˦˥
oóc	ʔ ɔ k̚ ˦˥
oải	ʔ w aː j ˨˩˦
oắt	ʔ w a k̚ ˦˥
oằn	ʔ w a ŋ ˨˩
oẳng	ʔ w a ŋ ˨˩˦
oặt	ʔ w a k̚ ˨˩˨
p	p e j ˧˧
palađi	p aː ˧˧ l aː ˧˧ ʔ ɗ ɪ j ˧˧
panh	p a n ˧˧
pao	p aː w ˧˧
parabol	p aː ˧˧ ɹ aː ˧˧ ʔ ɓ ɔ ŋ ˧˧
patriciô	p aː ˧˧ ʈ ɪ j ˧˧ s ɪ j ˧˧ ʔ o w ˧˧
pha	f aː ˧˧
phai	f aː j ˧˧
phan	f aː ŋ ˧˧
phang	f aː ŋ ˧˧
phanh	f a n ˧˧
phanxicô	f aː ŋ ˧˧ s ɪ j ˧˧ k o w ˧˧
phao	f aː w ˧˧
phaolô	f aː w ˧˧ l o w ˧˧
phau	f aː w ˧˧
phe	f ɛ ˧˧
phen	f ɛ ŋ ˧˧
phi	f ɪ j ˧˧
philípphê	f ɪ j ˧˧ l i p̚ ˦˥ f e j ˧˧
phim	f i m ˧˧
phin	f ɨ n ˧˧
phiên	f i ə ŋ ˧˧
phiếm	f i m ˦˥
phiến	f i ə ŋ ˦˥
phiếu	f i w ˦˥
phiền	f i ə ŋ ˨˩
pho	f ɔ ˧˧
phoi	f ɔ j ˧˧
phong	f a w ŋ͡m ˧˧
photpho	f o k̚ ˦˥ f ɔ ˧˧
phun	f ʊ w ŋ͡m ˧˧
phuy	f w ɪ j ˧˧
phà	f aː ˨˩
phàm	f aː m ˨˩
phá	f aː ˦˥
phác	f aː k̚ ˦˥
phách	f a t̚ ˦˥
phái	f aː j ˦˥
pháo	f aː w ˦˥
pháp	f aː p̚ ˦˥
phát	f aː k̚ ˦˥
phân	f ə ŋ ˧˧
phây	f ə j ˧˧
phè	f ɛ ˨˩
phèn	f ɛ ŋ ˨˩
phèo	f ɛ w ˨˩
phép	f ɛ p̚ ˦˥
phê	f e j ˧˧
phên	f əː n ˧˧
phêrô	f e j ˧˧ ɹ o w ˧˧
phình	f ɨ n ˨˩
phí	f ɪ j ˦˥
phía	f i ə ˦˥
phích	f ɨ t̚ ˦˥
phím	f i m ˦˥
phò	f ɔ ˨˩
phòi	f ɔ j ˨˩
phòng	f a w ŋ͡m ˨˩
phó	f ɔ ˦˥
phóng	f a w ŋ͡m ˦˥
phôi	f o j ˧˧
phông	f ə w ŋ͡m ˧˧
phù	f ʊ w ˨˩
phùn	f ʊ w ŋ͡m ˨˩
phùng	f ʊ w ŋ͡m ˨˩
phú	f ʊ w ˦˥
phúc	f ʊ w k͡p̚ ˦˥
phút	f ʊ k͡p̚ ˦˥
phũ	f ʊ w ˨˩˦
phơi	f əː j ˧˧
phương	f ɨ ə ŋ ˧˧
phước	f ɨ ə k̚ ˦˥
phường	f ɨ ə ŋ ˨˩
phượng	f ɨ ə ŋ ˨˩˨
phượt	f ɨ ə k̚ ˨˩˨
phạm	f aː m ˨˩˨
phạt	f aː k̚ ˨˩˨
phả	f aː ˨˩˦
phải	f aː j ˨˩˦
phản	f aː ŋ ˨˩˦
phấn	f ə ŋ ˦˥
phất	f ə k̚ ˦˥
phần	f ə ŋ ˨˩
phẩm	f ə m ˨˩˦
phẩy	f ə j ˨˩˦
phẫu	f ə w ˨˩˦
phận	f ə ŋ ˨˩˨
phật	f ə k̚ ˨˩˨
phẳng	f a ŋ ˨˩˦
phế	f e j ˦˥
phếch	f əː t̚ ˦˥
phết	f əː t̚ ˦˥
phễu	f e w ˨˩˦
phệ	f e j ˨˩˨
phỉ	f ɪ j ˨˩˦
phỉnh	f ɨ n ˨˩˦
phị	f ɪ j ˨˩˨
phịch	f ɨ t̚ ˨˩˨
phọt	f ɔ k̚ ˨˩˨
phỏng	f a w ŋ͡m ˨˩˦
phố	f o w ˦˥
phối	f o j ˦˥
phốt	f o k̚ ˦˥
phồng	f ə w ŋ͡m ˨˩
phổ	f o w ˨˩˦
phổi	f o j ˨˩˦
phới	f əː j ˦˥
phớt	f əː k̚ ˦˥
phở	f əː ˨˩˦
phụ	f ʊ w ˨˩˨
phục	f ʊ w k͡p̚ ˨˩˨
phụng	f ʊ w ŋ͡m ˨˩˨
phụt	f ʊ k͡p̚ ˨˩˨
phủ	f ʊ w ˨˩˦
phủi	f u j ˨˩˦
pin	p ɨ n ˧˧
piô	p ɪ j ˧˧ ʔ o w ˧˧
platin	p l aː ˧˧ t ɨ n ˧˧
pleiku	p əː ˨˩ l ə j ˧˧ k ʊ w ˧˧
plutoni	p l ʊ w ˧˧ t o w ˧˧ n ɪ j ˧˧
poloni	p o w ˧˧ l o w ˧˧ n ɪ j ˧˧
polyetylen	p ɔ ˧˧ l ɪ j ˧˧ ʔ e j ˧˧ t ɪ j ˧˧ l ɛ ŋ ˧˧
prazeođim	p ɹ aː ˧˧ z ɛ w ˧˧ ʔ ɗ i m ˧˧
prometi	p ɹ o w ˧˧ m e j ˧˧ t ɪ j ˧˧
protactini	ʔ ʊ w ˧˧ ɹ aː ˧˧ n ɪ j ˧˧
prôton	p ɹ o w ˧˧ t ə w ŋ͡m ˧˧
pê	p e j ˧˧
pích	p ɨ t̚ ˦˥
píp	p i p̚ ˦˥
pô	p o w ˧˧
q	k ʊ w ˧˧
qua	w aː ˧˧
quai	w aː j ˧˧
quan	w aː ŋ ˧˧
quang	w aː ŋ ˧˧
quanh	w a n ˧˧
quay	w a j ˧˧
que	w ɛ ˧˧
quen	w ɛ ŋ ˧˧
quy	w ɪ j ˧˧
quyên	w i ə ŋ ˧˧
quyến	w i ə ŋ ˦˥
quyết	w i ə k̚ ˦˥
quyền	w i ə ŋ ˨˩
quyển	w i ə ŋ ˨˩˦
quyện	w i ə ŋ ˨˩˨
quyệt	w i ə k̚ ˨˩˨
quà	w aː ˨˩
quàng	w aː ŋ ˨˩
quành	w a n ˨˩
quào	w aː w ˨˩
quá	w aː ˦˥
quách	w a t̚ ˦˥
quái	w aː j ˦˥
quán	w aː ŋ ˦˥
quát	w aː k̚ ˦˥
quân	w ə ŋ ˧˧
quây	w ə j ˧˧
quãng	w aː ŋ ˨˩˦
què	w ɛ ˨˩
qué	w ɛ ˦˥
quét	w ɛ t̚ ˦˥
quê	w e j ˧˧
quên	w əː n ˧˧
quít	w i t̚ ˦˥
quý	w ɪ j ˦˥
quýnh	w ɨ n ˦˥
quýt	w ɨ t̚ ˦˥
quýu	w i w ˦˥
quăn	w a ŋ ˧˧
quăng	w a ŋ ˧˧
quơ	w əː ˧˧
quạ	w aː ˨˩˨
quạc	w aː k̚ ˨˩˨
quạnh	w a n ˨˩˨
quạt	w aː k̚ ˨˩˨
quạu	w aː w ˨˩˨
quả	w aː ˨˩˦
quản	w aː ŋ ˨˩˦
quảng	w aː ŋ ˨˩˦
quảy	w a j ˨˩˦
quấc	w ə k̚ ˦˥
quấn	w ə ŋ ˦˥
quất	w ə k̚ ˦˥
quấy	w ə j ˦˥
quần	w ə ŋ ˨˩
quầy	w ə j ˨˩
quẩn	w ə ŋ ˨˩˦
quẩy	w ə j ˨˩˦
quẫy	w ə j ˨˩˦
quận	w ə ŋ ˨˩˨
quật	w ə k̚ ˨˩˨
quậy	w ə j ˨˩˨
quắt	w a k̚ ˦˥
quặm	w a m ˨˩˨
quặng	w a ŋ ˨˩˨
quặt	w a k̚ ˨˩˨
quẹo	w ɛ w ˨˩˨
quẹt	w ɛ t̚ ˨˩˨
quẻ	w ɛ ˨˩˦
quế	w e j ˦˥
quết	w əː t̚ ˦˥
quốc	k u ə k̚ ˦˥
quở	w əː ˨˩˦
quỳ	w ɪ j ˨˩
quỳnh	w ɨ n ˨˩
quỵ	w ɪ j ˨˩˨
quỵt	w ɨ t̚ ˨˩˨
quỷ	w ɪ j ˨˩˦
quỹ	w ɪ j ˨˩˦
r	ʔ ɛ ˧˧ ɹ əː ˨˩
ra	ɹ aː ˧˧
ram	ɹ aː m ˧˧
ran	ɹ aː ŋ ˧˧
rang	ɹ aː ŋ ˧˧
rao	ɹ aː w ˧˧
rau	ɹ aː w ˧˧
rađi	ɹ aː ˧˧ ʔ ɗ ɪ j ˧˧
rađon	ɹ aː ˧˧ ʔ ɗ ə w ŋ͡m ˧˧
ren	ɹ ɛ ŋ ˧˧
reni	ɹ e j ˧˧ n ɪ j ˧˧
ri	ɹ ɪ j ˧˧
ria	ɹ i ə ˧˧
rinh	ɹ ɨ n ˧˧
riêng	ɹ i ə ŋ ˧˧
riêu	ɹ i w ˧˧
riết	ɹ i ə k̚ ˦˥
riềng	ɹ i ə ŋ ˨˩
riệu	ɹ i w ˨˩˨
roi	ɹ ɔ j ˧˧
rong	ɹ a w ŋ͡m ˧˧
rođi	ɹ o w ˧˧ ʔ ɗ ɪ j ˧˧
ru	ɹ ʊ w ˧˧
rubiđi	ɹ ʊ w ˧˧ ʔ ɓ ɪ j ˧˧ ʔ ɗ ɪ j ˧˧
rum	ɹ ʊ m ˧˧
run	ɹ ʊ w ŋ͡m ˧˧
rung	ɹ ʊ w ŋ͡m ˧˧
ruteni	ɹ ʊ w ˧˧ t e j ˧˧ n ɪ j ˧˧
ruốc	ɹ u ə k̚ ˦˥
ruồi	ɹ u j ˨˩
ruộng	ɹ u ə ŋ ˨˩˨
ruột	ɹ u ə k̚ ˨˩˨
rà	ɹ aː ˨˩
ràn	ɹ aː ŋ ˨˩
ràng	ɹ aː ŋ ˨˩
rành	ɹ a n ˨˩
rào	ɹ aː w ˨˩
rày	ɹ aː j ˨˩
rá	ɹ aː ˦˥
rác	ɹ aː k̚ ˦˥
rách	ɹ a t̚ ˦˥
rái	ɹ aː j ˦˥
rán	ɹ aː ŋ ˦˥
ráng	ɹ aː ŋ ˦˥
ráo	ɹ aː w ˦˥
ráp	ɹ aː p̚ ˦˥
rát	ɹ aː k̚ ˦˥
ráy	ɹ aː j ˦˥
râm	ɹ ə m ˧˧
râu	ɹ ə w ˧˧
rây	ɹ ə j ˧˧
rã	ɹ aː ˨˩˦
rãnh	ɹ a n ˨˩˦
rèm	ɹ ɛ m ˨˩
rèn	ɹ ɛ ŋ ˨˩
ré	ɹ ɛ ˦˥
rén	ɹ ɛ ŋ ˦˥
réo	ɹ ɛ w ˦˥
rét	ɹ ɛ k̚ ˦˥
rê	ɹ e j ˧˧
rên	ɹ əː n ˧˧
rêu	ɹ e w ˧˧
rìa	ɹ i ə ˨˩
rình	ɹ ɨ n ˨˩
rìu	ɹ i w ˨˩
rích	ɹ ɨ t̚ ˦˥
rít	ɹ ɨ t̚ ˦˥
ríu	ɹ i w ˦˥
rò	ɹ ɔ ˨˩
ròm	ɹ ɔ m ˨˩
ròng	ɹ a w ŋ͡m ˨˩
rót	ɹ ɔ k̚ ˦˥
rô	ɹ o w ˧˧
rông	ɹ ə w ŋ͡m ˧˧
rõ	ɹ ɔ ˨˩˦
rùa	ɹ u ə ˨˩
rùm	ɹ ʊ m ˨˩
rùn	ɹ ʊ w ŋ͡m ˨˩
rùng	ɹ ʊ w ŋ͡m ˨˩
rú	ɹ ʊ w ˦˥
rúc	ɹ ʊ w k͡p̚ ˦˥
rún	ɹ ʊ w ŋ͡m ˦˥
rút	ɹ ʊ k͡p̚ ˦˥
răn	ɹ a ŋ ˧˧
răng	ɹ a ŋ ˧˧
rũ	ɹ ʊ w ˨˩˦
rũa	ɹ u ə ˨˩˦
rơ	ɹ əː ˧˧
rơi	ɹ əː j ˧˧
rơm	ɹ əː m ˧˧
rơzơfođi	ɹ əː ˧˧ z əː ˧˧ f ɔ ˧˧ ʔ ɗ ɪ j ˧˧
rươi	ɹ ɨ j ˧˧
rương	ɹ ɨ ə ŋ ˧˧
rước	ɹ ɨ ə k̚ ˦˥
rưới	ɹ ɨ j ˦˥
rướm	ɹ ɨ ə m ˦˥
rường	ɹ ɨ ə ŋ ˨˩
rưởi	ɹ ɨ j ˨˩˦
rưỡi	ɹ ɨ j ˨˩˦
rượt	ɹ ɨ ə k̚ ˨˩˨
rượu	ɹ ɨ ə w ˨˩˨
rạ	ɹ aː ˨˩˨
rạc	ɹ aː k̚ ˨˩˨
rạch	ɹ a t̚ ˨˩˨
rạn	ɹ aː ŋ ˨˩˨
rạng	ɹ aː ŋ ˨˩˨
rạp	ɹ aː p̚ ˨˩˨
rải	ɹ aː j ˨˩˦
rảnh	ɹ a n ˨˩˦
rảy	ɹ aː j ˨˩˦
rấm	ɹ ə m ˦˥
rấp	ɹ ə p̚ ˦˥
rất	ɹ ə k̚ ˦˥
rầm	ɹ ə m ˨˩
rầu	ɹ ə w ˨˩
rầy	ɹ ə j ˨˩
rẩy	ɹ ə j ˨˩˦
rẫy	ɹ ə j ˨˩˦
rậm	ɹ ə m ˨˩˨
rận	ɹ ə ŋ ˨˩˨
rập	ɹ ə p̚ ˨˩˨
rắc	ɹ a k̚ ˦˥
rắm	ɹ a m ˦˥
rắn	ɹ a ŋ ˦˥
rắp	ɹ a p̚ ˦˥
rằm	ɹ a m ˨˩
rằn	ɹ a ŋ ˨˩
rằng	ɹ a ŋ ˨˩
rặn	ɹ a ŋ ˨˩˨
rặng	ɹ a ŋ ˨˩˨
rẻ	ɹ ɛ ˨˩˦
rẻo	ɹ ɛ w ˨˩˦
rẽ	ɹ ɛ ˨˩˦
rế	ɹ e j ˦˥
rếch	ɹ əː t̚ ˦˥
rết	ɹ əː t̚ ˦˥
rề	ɹ e j ˨˩
rền	ɹ əː n ˨˩
rể	ɹ e j ˨˩˦
rễ	ɹ e j ˨˩˦
rệ	ɹ e j ˨˩˨
rệp	ɹ e p̚ ˨˩˨
rỉ	ɹ ɪ j ˨˩˦
rỉa	ɹ i ə ˨˩˦
rọ	ɹ ɔ ˨˩˨
rọc	ɹ a w k͡p̚ ˨˩˨
rọi	ɹ ɔ j ˨˩˨
rối	ɹ o j ˦˥
rốn	ɹ o ŋ ˦˥
rống	ɹ ə w ŋ͡m ˦˥
rốt	ɹ o k̚ ˦˥
rồ	ɹ o w ˨˩
rồi	ɹ o j ˨˩
rồng	ɹ ə w ŋ͡m ˨˩
rổ	ɹ o w ˨˩˦
rỗi	ɹ o j ˨˩˦
rỗng	ɹ ə w ŋ͡m ˨˩˦
rộ	ɹ o w ˨˩˨
rộn	ɹ o ŋ ˨˩˨
rộng	ɹ ə w ŋ͡m ˨˩˨
rớ	ɹ əː ˦˥
rớm	ɹ əː m ˦˥
rớt	ɹ əː k̚ ˦˥
rờ	ɹ əː ˨˩
rời	ɹ əː j ˨˩
rởm	ɹ əː m ˨˩˦
rỡ	ɹ əː ˨˩˦
rợ	ɹ əː ˨˩˨
rợn	ɹ əː ŋ ˨˩˨
rợp	ɹ əː p̚ ˨˩˨
rục	ɹ ʊ w k͡p̚ ˨˩˨
rụng	ɹ ʊ w ŋ͡m ˨˩˨
rụt	ɹ ʊ k͡p̚ ˨˩˨
rủ	ɹ ʊ w ˨˩˦
rủa	ɹ u ə ˨˩˦
rủi	ɹ u j ˨˩˦
rứa	ɹ ɨ ə ˦˥
rứt	ɹ ɨ k̚ ˦˥
rừng	ɹ ɨ ŋ ˨˩
rử	ɹ ɨ ˨˩˦
rửa	ɹ ɨ ə ˨˩˦
rữa	ɹ ɨ ə ˨˩˦
rựa	ɹ ɨ ə ˨˩˨
rực	ɹ ɨ k̚ ˨˩˨
s	ʔ ɛ k̚ ˦˥ ʂ ɪ j ˨˩
sa	ʂ aː ˧˧
sai	ʂ aː j ˧˧
sam	ʂ aː m ˧˧
samari	s aː ˧˧ m aː ˧˧ ɹ ɪ j ˧˧
san	ʂ aː ŋ ˧˧
sang	ʂ aː ŋ ˧˧
sanh	ʂ a n ˧˧
sao	ʂ aː w ˧˧
sau	ʂ aː w ˧˧
say	ʂ aː j ˧˧
scanđi	s k aː ŋ ˧˧ ʔ ɗ ɪ j ˧˧
selen	s e j ˧˧ l ɛ ŋ ˧˧
sen	ʂ ɛ ŋ ˧˧
seo	ʂ ɛ w ˧˧
si	ʂ ɪ j ˧˧
sida	s ɪ j ˧˧ ʔ ɗ aː ˧˧
silic	s ɪ j ˧˧ l ï k̟̚ ˦˥
sim	ʂ i m ˧˧
simon	ʂ ɪ j ˧˧ m ɔ ŋ ˧˧
sin	ʂ ɨ n ˧˧
sinh	ʂ ɨ n ˧˧
siêu	ʂ i w ˧˧
siết	ʂ i ə k̚ ˦˥
so	ʂ ɔ ˧˧
soi	ʂ ɔ j ˧˧
son	ʂ ɔ ŋ ˧˧
song	ʂ a w ŋ͡m ˧˧
soát	ʂ ⁽ʷ ⁾ aː k̚ ˦˥
soóc	ʂ ɔ k̚ ˦˥
soạn	ʂ ⁽ʷ ⁾ aː ŋ ˨˩˨
soọc	ʂ ɔ k̚ ˨˩˨
spam	s p a m ˧˧
stibi	s t ɪ j ˧˧ ʔ ɓ ɪ j ˧˧
stronti	ʂ t ɹ ɔ ŋ ˧˧ t ɪ j ˧˧
stêphanô	s t e j ˧˧ f aː ŋ ˧˧ n o w ˧˧
sui	ʂ u j ˧˧
sun	ʂ ʊ w ŋ͡m ˧˧
sung	ʂ ʊ w ŋ͡m ˧˧
suy	ʂ ⁽ʷ ⁾ ɪ j ˧˧
suyễn	ʂ ⁽ʷ ⁾ i ə ŋ ˨˩˦
suôn	ʂ u ə ŋ ˧˧
suýt	ʂ ⁽ʷ ⁾ ɨ t̚ ˦˥
suất	ʂ ⁽ʷ ⁾ ə k̚ ˦˥
suối	ʂ u j ˦˥
suốt	ʂ u ə k̚ ˦˥
suỵt	ʂ ⁽ʷ ⁾ ɨ t̚ ˨˩˨
sylvestrô	s i w ˧˧ v ɛ k̚ ˦˥ s t ɹ o w ˧˧
sài	ʂ aː j ˨˩
sàn	ʂ aː ŋ ˨˩
sàng	ʂ aː ŋ ˨˩
sành	ʂ a n ˨˩
sào	ʂ aː w ˨˩
sá	ʂ aː ˦˥
sách	ʂ a t̚ ˦˥
sái	ʂ aː j ˦˥
sán	ʂ aː ŋ ˦˥
sáng	ʂ aː ŋ ˦˥
sánh	ʂ a n ˦˥
sáo	ʂ aː w ˦˥
sáp	ʂ aː p̚ ˦˥
sát	ʂ aː k̚ ˦˥
sáu	ʂ aː w ˦˥
sâm	ʂ ə m ˧˧
sân	ʂ ə ŋ ˧˧
sâu	ʂ ə w ˧˧
sãi	ʂ aː j ˨˩˦
séc	ʂ ɛ k̚ ˦˥
sét	ʂ ɛ k̚ ˦˥
sên	ʂ əː n ˧˧
sênh	ʂ əː n ˧˧
sêvêrinô	s e j ˧˧ v e j ˧˧ ɹ ɪ j ˧˧ n o w ˧˧
sình	ʂ ɨ n ˨˩
sính	ʂ ɨ n ˦˥
síp	ʂ i p̚ ˦˥
sít	ʂ ɨ t̚ ˦˥
sò	ʂ ɔ ˨˩
sòng	ʂ a w ŋ͡m ˨˩
sóc	ʂ a w k͡p̚ ˦˥
sói	ʂ ɔ j ˦˥
sóng	ʂ a w ŋ͡m ˦˥
sót	ʂ ɔ k̚ ˦˥
sô	ʂ o w ˧˧
sôi	ʂ o j ˧˧
sông	ʂ ə w ŋ͡m ˧˧
sõi	ʂ ɔ j ˨˩˦
sùng	ʂ ʊ w ŋ͡m ˨˩
sú	ʂ ʊ w ˦˥
súc	ʂ ʊ w k͡p̚ ˦˥
sún	ʂ ʊ w ŋ͡m ˦˥
súng	ʂ ʊ w ŋ͡m ˦˥
sút	ʂ ʊ k͡p̚ ˦˥
săm	ʂ a m ˧˧
săn	ʂ a ŋ ˧˧
sĩ	ʂ ɪ j ˨˩˦
sũng	ʂ ʊ w ŋ͡m ˨˩˦
sơ	ʂ əː ˧˧
sơn	ʂ əː ŋ ˧˧
sư	ʂ ɨ ˧˧
sưa	ʂ ɨ ə ˧˧
sưng	ʂ ɨ ŋ ˧˧
sưu	ʂ ɨ w ˧˧
sương	ʂ ɨ ə ŋ ˧˧
sướng	ʂ ɨ ə ŋ ˦˥
sườn	ʂ ɨ ə ŋ ˨˩
sưởi	ʂ ɨ j ˨˩˦
sượng	ʂ ɨ ə ŋ ˨˩˨
sạc	ʂ aː k̚ ˨˩˨
sạch	ʂ a t̚ ˨˩˨
sạn	ʂ aː ŋ ˨˩˨
sạt	ʂ aː k̚ ˨˩˨
sả	ʂ aː ˨˩˦
sải	ʂ aː j ˨˩˦
sản	ʂ aː ŋ ˨˩˦
sảo	ʂ aː w ˨˩˦
sấm	ʂ ə m ˦˥
sấp	ʂ ə p̚ ˦˥
sấu	ʂ ə w ˦˥
sấy	ʂ ə j ˦˥
sầu	ʂ ə w ˨˩
sầy	ʂ ə j ˨˩
sẩy	ʂ ə j ˨˩˦
sẫm	ʂ ə m ˨˩˦
sậm	ʂ ə m ˨˩˨
sập	ʂ ə p̚ ˨˩˨
sậy	ʂ ə j ˨˩˨
sắc	ʂ a k̚ ˦˥
sắm	ʂ a m ˦˥
sắn	ʂ a ŋ ˦˥
sắp	ʂ a p̚ ˦˥
sắt	ʂ a k̚ ˦˥
sẵn	ʂ a ŋ ˨˩˦
sặc	ʂ a k̚ ˨˩˨
sẹo	ʂ ɛ w ˨˩˨
sẻ	ʂ ɛ ˨˩˦
sẽ	ʂ ɛ ˨˩˦
sến	ʂ əː n ˦˥
sếp	ʂ e p̚ ˦˥
sếu	ʂ e w ˦˥
sệt	ʂ əː t̚ ˨˩˨
sỉ	ʂ ɪ j ˨˩˦
sỉa	ʂ i ə ˨˩˦
sọ	ʂ ɔ ˨˩˨
sọc	ʂ a w k͡p̚ ˨˩˨
sọt	ʂ ɔ k̚ ˨˩˨
sỏ	ʂ ɔ ˨˩˦
sỏi	ʂ ɔ j ˨˩˦
số	ʂ o w ˦˥
sốc	ʂ ə w k͡p̚ ˦˥
sống	ʂ ə w ŋ͡m ˦˥
sốt	ʂ o k̚ ˦˥
sồi	ʂ o j ˨˩
sổ	ʂ o w ˨˩˦
sổng	ʂ ə w ŋ͡m ˨˩˦
sớm	ʂ əː m ˦˥
sớt	ʂ əː k̚ ˦˥
sờ	ʂ əː ˨˩
sờn	ʂ əː ŋ ˨˩
sở	ʂ əː ˨˩˦
sởi	ʂ əː j ˨˩˦
sởn	ʂ əː ŋ ˨˩˦
sợ	ʂ əː ˨˩˨
sợi	ʂ əː j ˨˩˨
sục	ʂ ʊ w k͡p̚ ˨˩˨
sụn	ʂ ʊ w ŋ͡m ˨˩˨
sụp	ʂ ʊ p̚ ˨˩˨
sụt	ʂ ʊ k͡p̚ ˨˩˨
sủa	ʂ u ə ˨˩˦
sủi	ʂ u j ˨˩˦
sứ	ʂ ɨ ˦˥
sứa	ʂ ɨ ə ˦˥
sức	ʂ ɨ k̚ ˦˥
sứt	ʂ ɨ k̚ ˦˥
sừng	ʂ ɨ ŋ ˨˩
sử	ʂ ɨ ˨˩˦
sửa	ʂ ɨ ə ˨˩˦
sửu	ʂ ɨ w ˨˩˦
sữa	ʂ ɨ ə ˨˩˦
sững	ʂ ɨ ŋ ˨˩˦
sự	ʂ ɨ ˨˩˨
sực	ʂ ɨ k̚ ˨˩˨
t	t e j ˧˧
ta	t aː ˧˧
tai	t aː j ˧˧
tali	t aː ˧˧ l ɪ j ˧˧
tam	t aː m ˧˧
tan	t aː ŋ ˧˧
tang	t aː ŋ ˧˧
tanh	t a n ˧˧
tantan	t aː n ˧˧ t aː n ˧˧
tao	t aː w ˧˧
tau	t aː w ˧˧
tay	t aː j ˧˧
tađêô	t aː ˧˧ ʔ ɗ e j ˧˧ ʔ o w ˧˧
tcn	ʈ ɨ ə k̚ ˦˥ k ə w ŋ͡m ˧˧ ŋ w i ə ŋ ˧˧
tebi	t ɛ ˧˧ ʔ ɓ ɪ j ˧˧
tecnexi	t ɛ k̚ ˦˥ n e j ˧˧ s ɪ j ˧˧
telex	t e j ˧˧ l əː t̚ ˦˥
telu	t ɛ ˧˧ l ʊ w ˧˧
tem	t ɛ m ˧˧
teo	t ɛ w ˧˧
tgp	t ə w ŋ͡m ˨˩˦ j aː w ˦˥ f ə ŋ ˨˩˨
tha	tʰ aː ˧˧
thai	tʰ aː j ˧˧
tham	tʰ aː m ˧˧
than	tʰ aː ŋ ˧˧
thang	tʰ aː ŋ ˧˧
thanh	tʰ a n ˧˧
thau	tʰ aː w ˧˧
thay	tʰ aː j ˧˧
thcs	ʈ ʊ w ŋ͡m ˧˧ h a w k͡p̚ ˨˩˨ k əː ˧˧ ʂ əː ˨˩˦
the	tʰ ɛ ˧˧
then	tʰ ɛ ŋ ˧˧
theo	tʰ ɛ w ˧˧
thi	tʰ ɪ j ˧˧
thinh	tʰ ɨ n ˧˧
thiu	tʰ i w ˧˧
thiên	tʰ i ə ŋ ˧˧
thiêng	tʰ i ə ŋ ˧˧
thiêu	tʰ i w ˧˧
thiếc	tʰ i ə k̚ ˦˥
thiến	tʰ i ə ŋ ˦˥
thiếp	tʰ i p̚ ˦˥
thiết	tʰ i ə k̚ ˦˥
thiếu	tʰ i w ˦˥
thiền	tʰ i ə ŋ ˨˩
thiện	tʰ i ə ŋ ˨˩˨
thiệt	tʰ i ə k̚ ˨˩˨
thoa	tʰ ⁽ʷ ⁾ aː ˧˧
thoi	tʰ ɔ j ˧˧
thon	tʰ ɔ ŋ ˧˧
thori	tʰ ɔ ˧˧ ɹ ɪ j ˧˧
thoáng	tʰ ⁽ʷ ⁾ aː ŋ ˦˥
thoát	tʰ ⁽ʷ ⁾ aː k̚ ˦˥
thoại	tʰ ⁽ʷ ⁾ aː j ˨˩˨
thoạt	tʰ ⁽ʷ ⁾ aː k̚ ˨˩˨
thoả	tʰ ⁽ʷ ⁾ aː ˨˩˦
thoải	tʰ ⁽ʷ ⁾ aː j ˨˩˦
thoảng	tʰ ⁽ʷ ⁾ aː ŋ ˨˩˦
thpt	ʈ ʊ w ŋ͡m ˧˧ h a w k͡p̚ ˨˩˨ f o w ˨˩˦ tʰ ə w ŋ͡m ˧˧
thu	tʰ ʊ w ˧˧
thua	tʰ u ə ˧˧
thui	tʰ u j ˧˧
thun	tʰ ʊ w ŋ͡m ˧˧
thung	tʰ ʊ w ŋ͡m ˧˧
thuyết	tʰ ⁽ʷ ⁾ i ə k̚ ˦˥
thuyền	tʰ ⁽ʷ ⁾ i ə ŋ ˨˩
thuê	tʰ ⁽ʷ ⁾ e j ˧˧
thuôn	tʰ u ə ŋ ˧˧
thuý	tʰ ⁽ʷ ⁾ ɪ j ˦˥
thuần	tʰ ⁽ʷ ⁾ ə ŋ ˨˩
thuận	tʰ ⁽ʷ ⁾ ə ŋ ˨˩˨
thuật	tʰ ⁽ʷ ⁾ ə k̚ ˨˩˨
thuế	tʰ ⁽ʷ ⁾ e j ˦˥
thuốc	tʰ u ə k̚ ˦˥
thuổng	tʰ u ə ŋ ˨˩˦
thuộc	tʰ u ə k̚ ˨˩˨
thuở	tʰ ⁽ʷ ⁾ əː ˨˩˦
thuỳ	tʰ ⁽ʷ ⁾ ɪ j ˨˩
thuỵ	tʰ ⁽ʷ ⁾ ɪ j ˨˩˨
thuỷ	tʰ ⁽ʷ ⁾ ɪ j ˨˩˦
thà	tʰ aː ˨˩
thành	tʰ a n ˨˩
thác	tʰ aː k̚ ˦˥
thách	tʰ a t̚ ˦˥
thái	tʰ aː j ˦˥
tháng	tʰ aː ŋ ˦˥
thánh	tʰ a n ˦˥
tháo	tʰ aː w ˦˥
tháp	tʰ aː p̚ ˦˥
tháu	tʰ aː w ˦˥
thâm	tʰ ə m ˧˧
thân	tʰ ə ŋ ˧˧
thâu	tʰ ə w ˧˧
thây	tʰ ə j ˧˧
thè	tʰ ɛ ˨˩
thèm	tʰ ɛ m ˨˩
thép	tʰ ɛ p̚ ˦˥
thêm	tʰ e m ˧˧
thêu	tʰ e w ˧˧
thêôđorô	tʰ e j ˧˧ ʔ o w ˧˧ ʔ ɗ ɔ ˧˧ ɹ o w ˧˧
thì	tʰ ɪ j ˨˩
thìa	tʰ i ə ˨˩
thìn	tʰ ɨ n ˨˩
thí	tʰ ɪ j ˦˥
thích	tʰ ɨ t̚ ˦˥
thím	tʰ i m ˦˥
thính	tʰ ɨ n ˦˥
thò	tʰ ɔ ˨˩
thòng	tʰ a w ŋ͡m ˨˩
thóc	tʰ a w k͡p̚ ˦˥
thói	tʰ ɔ j ˦˥
thóp	tʰ ɔ p̚ ˦˥
thô	tʰ o w ˧˧
thôi	tʰ o j ˧˧
thôn	tʰ o ŋ ˧˧
thông	tʰ ə w ŋ͡m ˧˧
thù	tʰ ʊ w ˨˩
thùa	tʰ u ə ˨˩
thùng	tʰ ʊ w ŋ͡m ˨˩
thú	tʰ ʊ w ˦˥
thúc	tʰ ʊ w k͡p̚ ˦˥
thúi	tʰ u j ˦˥
thúng	tʰ ʊ w ŋ͡m ˦˥
thăm	tʰ a m ˧˧
thăn	tʰ a ŋ ˧˧
thăng	tʰ a ŋ ˧˧
thơ	tʰ əː ˧˧
thơm	tʰ əː m ˧˧
thư	tʰ ɨ ˧˧
thưa	tʰ ɨ ə ˧˧
thương	tʰ ɨ ə ŋ ˧˧
thước	tʰ ɨ ə k̚ ˦˥
thường	tʰ ɨ ə ŋ ˨˩
thưởng	tʰ ɨ ə ŋ ˨˩˦
thượng	tʰ ɨ ə ŋ ˨˩˨
thạch	tʰ a t̚ ˨˩˨
thạo	tʰ aː w ˨˩˨
thả	tʰ aː ˨˩˦
thải	tʰ aː j ˨˩˦
thảm	tʰ aː m ˨˩˦
thảo	tʰ aː w ˨˩˦
thảy	tʰ aː j ˨˩˦
thấm	tʰ ə m ˦˥
thấp	tʰ ə p̚ ˦˥
thất	tʰ ə k̚ ˦˥
thấu	tʰ ə w ˦˥
thấy	tʰ ə j ˦˥
thầm	tʰ ə m ˨˩
thần	tʰ ə ŋ ˨˩
thầu	tʰ ə w ˨˩
thầy	tʰ ə j ˨˩
thẩy	tʰ ə j ˨˩˦
thận	tʰ ə ŋ ˨˩˨
thập	tʰ ə p̚ ˨˩˨
thật	tʰ ə k̚ ˨˩˨
thắm	tʰ a m ˦˥
thắng	tʰ a ŋ ˦˥
thắp	tʰ a p̚ ˦˥
thắt	tʰ a k̚ ˦˥
thằng	tʰ a ŋ ˨˩
thẳm	tʰ a m ˨˩˦
thẳng	tʰ a ŋ ˨˩˦
thẹn	tʰ ɛ ŋ ˨˩˨
thẹo	tʰ ɛ w ˨˩˨
thẻ	tʰ ɛ ˨˩˦
thế	tʰ e j ˦˥
thề	tʰ e j ˨˩
thềm	tʰ e m ˨˩
thể	tʰ e j ˨˩˦
thị	tʰ ɪ j ˨˩˨
thịch	tʰ ɨ t̚ ˨˩˨
thịnh	tʰ ɨ n ˨˩˨
thịt	tʰ ɨ t̚ ˨˩˨
thọ	tʰ ɔ ˨˩˨
thọc	tʰ a w k͡p̚ ˨˩˨
thọt	tʰ ɔ k̚ ˨˩˨
thỏ	tʰ ɔ ˨˩˦
thối	tʰ o j ˦˥
thốn	tʰ o ŋ ˦˥
thống	tʰ ə w ŋ͡m ˦˥
thốt	tʰ o k̚ ˦˥
thồn	tʰ o ŋ ˨˩
thổ	tʰ o w ˨˩˦
thổi	tʰ o j ˨˩˦
thớt	tʰ əː k̚ ˦˥
thờ	tʰ əː ˨˩
thời	tʰ əː j ˨˩
thở	tʰ əː ˨˩˦
thợ	tʰ əː ˨˩˨
thụ	tʰ ʊ w ˨˩˨
thục	tʰ ʊ w k͡p̚ ˨˩˨
thụt	tʰ ʊ k͡p̚ ˨˩˨
thủ	tʰ ʊ w ˨˩˦
thủa	tʰ u ə ˨˩˦
thủm	tʰ ʊ m ˨˩˦
thủng	tʰ ʊ w ŋ͡m ˨˩˦
thứ	tʰ ɨ ˦˥
thức	tʰ ɨ k̚ ˦˥
thừ	tʰ ɨ ˨˩
thừa	tʰ ɨ ə ˨˩
thừng	tʰ ɨ ŋ ˨˩
thử	tʰ ɨ ˨˩˦
thực	tʰ ɨ k̚ ˨˩˨
ti	t ɪ j ˧˧
tia	t i ə ˧˧
tim	t i m ˧˧
tin	t ɨ n ˧˧
tinh	t ɨ n ˧˧
titan	t ɪ j ˧˧ t aː n ˧˧
tiêm	t i m ˧˧
tiên	t i ə ŋ ˧˧
tiêu	t i w ˧˧
tiếc	t i ə k̚ ˦˥
tiến	t i ə ŋ ˦˥
tiếng	t i ə ŋ ˦˥
tiếp	t i p̚ ˦˥
tiết	t i ə k̚ ˦˥
tiền	t i ə ŋ ˨˩
tiều	t i w ˨˩
tiểu	t i w ˨˩˦
tiễn	t i ə ŋ ˨˩˦
tiệc	t i ə k̚ ˨˩˨
tiệm	t i m ˨˩˨
tiện	t i ə ŋ ˨˩˨
tiệp	t i p̚ ˨˩˨
to	t ɔ ˧˧
toa	t ⁽ʷ ⁾ aː ˧˧
toan	t ⁽ʷ ⁾ aː ŋ ˧˧
toang	t ⁽ʷ ⁾ aː ŋ ˧˧
toe	t ⁽ʷ ⁾ ɛ ˧˧
toi	t ɔ j ˧˧
tong	t a w ŋ͡m ˧˧
toà	t ⁽ʷ ⁾ aː ˨˩
toàn	t ⁽ʷ ⁾ aː ŋ ˨˩
toác	t ⁽ʷ ⁾ aː k̚ ˦˥
toán	t ⁽ʷ ⁾ aː ŋ ˦˥
toáng	t ⁽ʷ ⁾ aː ŋ ˦˥
toát	t ⁽ʷ ⁾ aː k̚ ˦˥
toé	t ⁽ʷ ⁾ ɛ ˦˥
toét	t ⁽ʷ ⁾ ɛ k̚ ˦˥
toả	t ⁽ʷ ⁾ aː ˨˩˦
tp	tʰ a n ˨˩ f o w ˦˥
tphcm	tʰ a n ˨˩ f o w ˦˥ h o w ˨˩ c ɪ j ˦˥ m ɨ n ˧˧
tra	ʈ aː ˧˧
trai	ʈ aː j ˧˧
trang	ʈ aː ŋ ˧˧
tranh	ʈ a n ˧˧
trao	ʈ aː w ˧˧
trau	ʈ aː w ˧˧
tre	ʈ ɛ ˧˧
treo	ʈ ɛ w ˧˧
trinh	ʈ ɨ n ˧˧
triết	ʈ i ə k̚ ˦˥
triền	ʈ i ə ŋ ˨˩
triều	ʈ i w ˨˩
triện	ʈ i ə ŋ ˨˩˨
triệt	ʈ i ə k̚ ˨˩˨
triệu	ʈ i w ˨˩˨
tro	ʈ ɔ ˧˧
trong	ʈ a w ŋ͡m ˧˧
tru	ʈ ʊ w ˧˧
trung	ʈ ʊ w ŋ͡m ˧˧
truy	ʈ ⁽ʷ ⁾ ɪ j ˧˧
truyền	ʈ ⁽ʷ ⁾ i ə ŋ ˨˩
truyện	ʈ ⁽ʷ ⁾ i ə ŋ ˨˩˨
truông	ʈ u ə ŋ ˧˧
truất	ʈ ⁽ʷ ⁾ ə k̚ ˦˥
truồng	ʈ u ə ŋ ˨˩
trà	ʈ aː ˨˩
tràm	ʈ aː m ˨˩
tràn	ʈ aː ŋ ˨˩
tràng	ʈ aː ŋ ˨˩
trào	ʈ aː w ˨˩
trách	ʈ a t̚ ˦˥
trái	ʈ aː j ˦˥
trám	ʈ aː m ˦˥
trán	ʈ aː ŋ ˦˥
tráng	ʈ aː ŋ ˦˥
tránh	ʈ a n ˦˥
tráo	ʈ aː w ˦˥
tráp	ʈ aː p̚ ˦˥
trát	ʈ aː k̚ ˦˥
trâm	ʈ ə m ˧˧
trân	ʈ ə ŋ ˧˧
trâu	ʈ ə w ˧˧
trã	ʈ aː ˨˩˦
trèo	ʈ ɛ w ˨˩
trét	ʈ ɛ k̚ ˦˥
trên	ʈ əː n ˧˧
trêu	ʈ e w ˧˧
trình	ʈ ɨ n ˨˩
trí	ʈ ɪ j ˦˥
trích	ʈ ɨ t̚ ˦˥
trò	ʈ ɔ ˨˩
tròn	ʈ ɔ ŋ ˨˩
tròng	ʈ a w ŋ͡m ˨˩
tróc	ʈ a w k͡p̚ ˦˥
trói	ʈ ɔ j ˦˥
trót	ʈ ɔ k̚ ˦˥
trôi	ʈ o j ˧˧
trông	ʈ ə w ŋ͡m ˧˧
trù	ʈ ʊ w ˨˩
trùm	ʈ ʊ m ˨˩
trùn	ʈ ʊ w ŋ͡m ˨˩
trùng	ʈ ʊ w ŋ͡m ˨˩
trú	ʈ ʊ w ˦˥
trúc	ʈ ʊ w k͡p̚ ˦˥
trúng	ʈ ʊ w ŋ͡m ˦˥
trút	ʈ ʊ k͡p̚ ˦˥
trăm	ʈ a m ˧˧
trăn	ʈ a ŋ ˧˧
trăng	ʈ a ŋ ˧˧
trĩ	ʈ ɪ j ˨˩˦
trĩu	ʈ i w ˨˩˦
trũng	ʈ ʊ w ŋ͡m ˨˩˦
trơ	ʈ əː ˧˧
trơn	ʈ əː ŋ ˧˧
trưa	ʈ ɨ ə ˧˧
trưng	ʈ ɨ ŋ ˧˧
trương	ʈ ɨ ə ŋ ˧˧
trước	ʈ ɨ ə k̚ ˦˥
trườn	ʈ ɨ ə ŋ ˨˩
trường	ʈ ɨ ə ŋ ˨˩
trưởng	ʈ ɨ ə ŋ ˨˩˦
trượng	ʈ ɨ ə ŋ ˨˩˨
trượt	ʈ ɨ ə k̚ ˨˩˨
trạc	ʈ aː k̚ ˨˩˨
trại	ʈ aː j ˨˩˨
trạm	ʈ aː m ˨˩˨
trạng	ʈ aː ŋ ˨˩˨
trả	ʈ aː ˨˩˦
trải	ʈ aː j ˨˩˦
trảm	ʈ aː m ˨˩˦
trảng	ʈ aː ŋ ˨˩˦
trấn	ʈ ə ŋ ˦˥
trấu	ʈ ə w ˦˥
trầm	ʈ ə m ˨˩
trần	ʈ ə ŋ ˨˩
trầu	ʈ ə w ˨˩
trầy	ʈ ə j ˨˩
trẩu	ʈ ə w ˨˩˦
trẫm	ʈ ə m ˨˩˦
trận	ʈ ə ŋ ˨˩˨
trật	ʈ ə k̚ ˨˩˨
trắc	ʈ a k̚ ˦˥
trắm	ʈ a m ˦˥
trắng	ʈ a ŋ ˦˥
trặc	ʈ a k̚ ˨˩˨
trẹo	ʈ ɛ w ˨˩˨
trẻ	ʈ ɛ ˨˩˦
trề	ʈ e j ˨˩
trển	ʈ əː n ˨˩˦
trễ	ʈ e j ˨˩˦
trệt	ʈ əː t̚ ˨˩˨
trị	ʈ ɪ j ˨˩˨
trịnh	ʈ ɨ n ˨˩˨
trọ	ʈ ɔ ˨˩˨
trọc	ʈ a w k͡p̚ ˨˩˨
trọi	ʈ ɔ j ˨˩˨
trọn	ʈ ɔ ŋ ˨˩˨
trọng	ʈ a w ŋ͡m ˨˩˨
trỏ	ʈ ɔ ˨˩˦
trỏng	ʈ a w ŋ͡m ˨˩˦
trốc	ʈ ə w k͡p̚ ˦˥
trốn	ʈ o ŋ ˦˥
trống	ʈ ə w ŋ͡m ˦˥
trồi	ʈ o j ˨˩
trồng	ʈ ə w ŋ͡m ˨˩
trổ	ʈ o w ˨˩˦
trội	ʈ o j ˨˩˨
trộm	ʈ o m ˨˩˨
trộn	ʈ o ŋ ˨˩˨
trớn	ʈ əː ŋ ˦˥
trời	ʈ əː j ˨˩
trở	ʈ əː ˨˩˦
trợn	ʈ əː ŋ ˨˩˨
trụ	ʈ ʊ w ˨˩˨
trục	ʈ ʊ w k͡p̚ ˨˩˨
trụi	ʈ u j ˨˩˨
trụng	ʈ ʊ w ŋ͡m ˨˩˨
trủ	ʈ ʊ w ˨˩˦
trứng	ʈ ɨ ŋ ˦˥
trừ	ʈ ɨ ˨˩
trữ	ʈ ɨ ˨˩˦
trực	ʈ ɨ k̚ ˨˩˨
ttx	tʰ ə w ŋ͡m ˧˧ t ə ŋ ˦˥ s aː ˨˩˦
tu	t ʊ w ˧˧
tua	t u ə ˧˧
tui	t u j ˧˧
tuli	t ʊ w ˧˧ l ɪ j ˧˧
tum	t ʊ m ˧˧
tung	t ʊ w ŋ͡m ˧˧
tuy	t ⁽ʷ ⁾ ɪ j ˧˧
tuyến	t ⁽ʷ ⁾ i ə ŋ ˦˥
tuyết	t ⁽ʷ ⁾ i ə k̚ ˦˥
tuyển	t ⁽ʷ ⁾ i ə ŋ ˨˩˦
tuyệt	t ⁽ʷ ⁾ i ə k̚ ˨˩˨
tuân	t ⁽ʷ ⁾ ə ŋ ˧˧
tuôn	t u ə ŋ ˧˧
tuýp	t ⁽ʷ ⁾ i p̚ ˦˥
tuấn	t ⁽ʷ ⁾ ə ŋ ˦˥
tuất	t ⁽ʷ ⁾ ə k̚ ˦˥
tuần	t ⁽ʷ ⁾ ə ŋ ˨˩
tuế	t ⁽ʷ ⁾ e j ˦˥
tuốt	t u ə k̚ ˦˥
tuồng	t u ə ŋ ˨˩
tuổi	t u j ˨˩˦
tuột	t u ə k̚ ˨˩˨
tuỳ	t ⁽ʷ ⁾ ɪ j ˨˩
tuỵ	t ⁽ʷ ⁾ ɪ j ˨˩˨
tuỷ	t ⁽ʷ ⁾ ɪ j ˨˩˦
tv	t ɪ j ˧˧ v ɪ j ˧˧
tà	t aː ˨˩
tài	t aː j ˨˩
tàn	t aː ŋ ˨˩
tàng	t aː ŋ ˨˩
tàu	t aː w ˨˩
tày	t aː j ˨˩
tá	t aː ˦˥
tách	t a t̚ ˦˥
tái	t aː j ˦˥
tám	t aː m ˦˥
tán	t aː ŋ ˦˥
táng	t aː ŋ ˦˥
tánh	t a n ˦˥
táo	t aː w ˦˥
táp	t aː p̚ ˦˥
tát	t aː k̚ ˦˥
tâm	t ə m ˧˧
tân	t ə ŋ ˧˧
tâng	t ə ŋ ˧˧
tâu	t ə w ˧˧
tây	t ə j ˧˧
tã	t aː ˨˩˦
tãi	t aː j ˨˩˦
tè	t ɛ ˨˩
té	t ɛ ˦˥
tém	t ɛ m ˦˥
tép	t ɛ p̚ ˦˥
tét	t ɛ k̚ ˦˥
tê	t e j ˧˧
têhêrăng	t e j ˧˧ h e j ˧˧ ɹ a ŋ ˧˧
têm	t e m ˧˧
tên	t əː n ˧˧
tênh	t əː n ˧˧
têooc	t e j ˧˧ ʔ ɔ k̚ ˧˧
têrêsa	t e j ˧˧ ɹ e j ˧˧ s aː ˧˧
tìm	t i m ˨˩
tình	t ɨ n ˨˩
tí	t ɪ j ˦˥
tía	t i ə ˦˥
tích	t ɨ t̚ ˦˥
tím	t i m ˦˥
tính	t ɨ n ˦˥
típ	t i p̚ ˦˥
tít	t ɨ t̚ ˦˥
tóc	t a w k͡p̚ ˦˥
tóm	t ɔ m ˦˥
tót	t ɔ k̚ ˦˥
tô	t o w ˧˧
tôi	t o j ˧˧
tôm	t o m ˧˧
tôma	t o w ˧˧ m aː ˧˧
tôn	t o ŋ ˧˧
tông	t ə w ŋ͡m ˧˧
tõm	t ɔ m ˨˩˦
tù	t ʊ w ˨˩
tùng	t ʊ w ŋ͡m ˨˩
tú	t ʊ w ˦˥
túa	t u ə ˦˥
túi	t u j ˦˥
túm	t ʊ m ˦˥
tút	t ʊ k͡p̚ ˦˥
tăm	t a m ˧˧
tăng	t a ŋ ˧˧
tơ	t əː ˧˧
tơi	t əː j ˧˧
tư	t ɨ ˧˧
tưng	t ɨ ŋ ˧˧
tươi	t ɨ j ˧˧
tươm	t ɨ ə m ˧˧
tương	t ɨ ə ŋ ˧˧
tước	t ɨ ə k̚ ˦˥
tưới	t ɨ j ˦˥
tướng	t ɨ ə ŋ ˦˥
tường	t ɨ ə ŋ ˨˩
tườu	t ɨ ə w ˨˩
tưởng	t ɨ ə ŋ ˨˩˦
tượng	t ɨ ə ŋ ˨˩˨
tạ	t aː ˨˩˨
tạc	t aː k̚ ˨˩˨
tại	t aː j ˨˩˨
tạm	t aː m ˨˩˨
tạng	t aː ŋ ˨˩˨
tạnh	t a n ˨˩˨
tạo	t aː w ˨˩˨
tạt	t aː k̚ ˨˩˨
tả	t aː ˨˩˦
tải	t aː j ˨˩˦
tản	t aː ŋ ˨˩˦
tảng	t aː ŋ ˨˩˦
tảo	t aː w ˨˩˦
tấc	t ə k̚ ˦˥
tấm	t ə m ˦˥
tấn	t ə ŋ ˦˥
tất	t ə k̚ ˦˥
tấu	t ə w ˦˥
tầm	t ə m ˨˩
tầng	t ə ŋ ˨˩
tẩm	t ə m ˨˩˦
tẩn	t ə ŋ ˨˩˦
tẩu	t ə w ˨˩˦
tẩy	t ə j ˨˩˦
tận	t ə ŋ ˨˩˨
tập	t ə p̚ ˨˩˨
tật	t ə k̚ ˨˩˨
tậu	t ə w ˨˩˨
tắc	t a k̚ ˦˥
tắm	t a m ˦˥
tắp	t a p̚ ˦˥
tắt	t a k̚ ˦˥
tằm	t a m ˨˩
tặc	t a k̚ ˨˩˨
tặng	t a ŋ ˨˩˨
tẹo	t ɛ w ˨˩˨
tẹt	t ɛ k̚ ˨˩˨
tẻ	t ɛ ˨˩˦
tế	t e j ˦˥
tếch	t əː t̚ ˦˥
tết	t əː t̚ ˦˥
tệ	t e j ˨˩˨
tệp	t e p̚ ˨˩˨
tỉ	t ɪ j ˨˩˦
tỉa	t i ə ˨˩˦
tỉnh	t ɨ n ˨˩˦
tị	t ɪ j ˨˩˨
tịch	t ɨ t̚ ˨˩˨
tịt	t ɨ t̚ ˨˩˨
tọp	t ɔ p̚ ˨˩˨
tỏ	t ɔ ˨˩˦
tỏi	t ɔ j ˨˩˦
tỏm	t ɔ m ˨˩˦
tố	t o w ˦˥
tốc	t ə w k͡p̚ ˦˥
tối	t o j ˦˥
tốn	t o ŋ ˦˥
tống	t ə w ŋ͡m ˦˥
tốp	t o p̚ ˦˥
tốt	t o k̚ ˦˥
tồi	t o j ˨˩
tồn	t o ŋ ˨˩
tổ	t o w ˨˩˦
tổng	t ə w ŋ͡m ˨˩˦
tộ	t o w ˨˩˨
tộc	t ə w k͡p̚ ˨˩˨
tội	t o j ˨˩˨
tột	t o k̚ ˨˩˨
tớ	t əː ˦˥
tới	t əː j ˦˥
tờ	t əː ˨˩
tởm	t əː m ˨˩˦
tởn	t əː ŋ ˨˩˦
tợ	t əː ˨˩˨
tợn	t əː ŋ ˨˩˨
tợp	t əː p̚ ˨˩˨
tục	t ʊ w k͡p̚ ˨˩˨
tụi	t u j ˨˩˨
tụm	t ʊ m ˨˩˨
tụng	t ʊ w ŋ͡m ˨˩˨
tụt	t ʊ k͡p̚ ˨˩˨
tủ	t ʊ w ˨˩˦
tủi	t u j ˨˩˦
tức	t ɨ k̚ ˦˥
từ	t ɨ ˨˩
từng	t ɨ ŋ ˨˩
tử	t ɨ ˨˩˦
tửu	t ɨ w ˨˩˦
tự	t ɨ ˨˩˨
tựa	t ɨ ə ˨˩˨
u	ʔ ʊ w ˧˧
ung	ʔ ʊ w ŋ͡m ˧˧
urani	ʔ ʊ w ˧˧ ɹ aː ˧˧ n ɪ j ˧˧
urbanô	ʔ w əː ˧˧ ʔ ɓ aː ŋ ˧˧ n o w ˧˧
uyên	ʔ w i ə ŋ ˧˧
uên	ʔ w əː n ˧˧
uôn	ʔ u ə ŋ ˧˧
uý	ʔ w ɪ j ˦˥
uất	ʔ w ə k̚ ˦˥
uốn	ʔ u ə ŋ ˦˥
uống	ʔ u ə ŋ ˦˥
uổng	ʔ u ə ŋ ˨˩˦
v	v e j ˧˧
va	v aː ˧˧
vai	v aː j ˧˧
valentinô	v aː ˧˧ l ɛ ŋ ˧˧ t ɨ n ˧˧ n o w ˧˧
van	v aː ŋ ˧˧
vanađi	v aː ˧˧ n aː ˧˧ ʔ ɗ ɪ j ˧˧
vang	v aː ŋ ˧˧
vay	v aː j ˧˧
ve	v ɛ ˧˧
vectơ	v ɛ k̚ ˦˥ t əː ˧˧
ven	v ɛ ŋ ˧˧
vi	v ɪ j ˧˧
victor	v ɨ t̚ ˦˥ t ɔ ˧˧
vinh	v ɨ n ˧˧
viêm	v i m ˧˧
viên	v i ə ŋ ˧˧
viếng	v i ə ŋ ˦˥
viết	v i ə k̚ ˦˥
viền	v i ə ŋ ˨˩
việc	v i ə k̚ ˨˩˨
viện	v i ə ŋ ˨˩˨
việt	v i ə k̚ ˨˩˨
vo	v ɔ ˧˧
voa	v w aː ˧˧
voan	v w aː ŋ ˧˧
voi	v ɔ j ˧˧
vonfam	v o ŋ ˧˧ f aː m ˧˧
voọc	v ɔ k̚ ˨˩˨
vu	v ʊ w ˧˧
vua	v u ə ˧˧
vui	v u j ˧˧
vun	v ʊ w ŋ͡m ˧˧
vung	v ʊ w ŋ͡m ˧˧
vuông	v u ə ŋ ˧˧
vuốt	v u ə k̚ ˦˥
vuột	v u ə k̚ ˨˩˨
vy	v ɪ j ˧˧
và	v aː ˨˩
vài	v aː j ˨˩
vàng	v aː ŋ ˨˩
vành	v a n ˨˩
vào	v aː w ˨˩
vá	v aː ˦˥
vác	v aː k̚ ˦˥
vách	v a t̚ ˦˥
vái	v aː j ˦˥
ván	v aː ŋ ˦˥
váng	v aː ŋ ˦˥
váy	v aː j ˦˥
vân	v ə ŋ ˧˧
vâng	v ə ŋ ˧˧
vây	v ə j ˧˧
vã	v aː ˨˩˦
vãi	v aː j ˨˩˦
vè	v ɛ ˨˩
vé	v ɛ ˦˥
vén	v ɛ ŋ ˦˥
véo	v ɛ w ˦˥
vét	v ɛ k̚ ˦˥
vê	v e j ˧˧
vênh	v əː n ˧˧
vì	v ɪ j ˨˩
ví	v ɪ j ˦˥
vía	v i ə ˦˥
vích	v ɨ t̚ ˦˥
vít	v ɨ t̚ ˦˥
víu	v i w ˦˥
vò	v ɔ ˨˩
vòi	v ɔ j ˨˩
vòm	v ɔ m ˨˩
vòng	v a w ŋ͡m ˨˩
vó	v ɔ ˦˥
vóc	v a w k͡p̚ ˦˥
vón	v ɔ ŋ ˦˥
vót	v ɔ k̚ ˦˥
vô	v o w ˧˧
vôi	v o j ˧˧
vôn	v o ŋ ˧˧
võ	v ɔ ˨˩˦
võng	v a w ŋ͡m ˨˩˦
vù	v ʊ w ˨˩
vùi	v u j ˨˩
vùng	v ʊ w ŋ͡m ˨˩
vú	v ʊ w ˦˥
vút	v ʊ k͡p̚ ˦˥
văn	v a ŋ ˧˧
văng	v a ŋ ˧˧
vĩ	v ɪ j ˨˩˦
vũ	v ʊ w ˨˩˦
vũng	v ʊ w ŋ͡m ˨˩˦
vơi	v əː j ˧˧
vưu	v ɨ w ˧˧
vươn	v ɨ ə ŋ ˧˧
vương	v ɨ ə ŋ ˧˧
vướng	v ɨ ə ŋ ˦˥
vườn	v ɨ ə ŋ ˨˩
vượn	v ɨ ə ŋ ˨˩˨
vượng	v ɨ ə ŋ ˨˩˨
vượt	v ɨ ə k̚ ˨˩˨
vạ	v aː ˨˩˨
vạc	v aː k̚ ˨˩˨
vạch	v a t̚ ˨˩˨
vạn	v aː ŋ ˨˩˨
vạt	v aː k̚ ˨˩˨
vả	v aː ˨˩˦
vải	v aː j ˨˩˦
vảy	v aː j ˨˩˦
vấn	v ə ŋ ˦˥
vấp	v ə p̚ ˦˥
vất	v ə k̚ ˦˥
vấy	v ə j ˦˥
vần	v ə ŋ ˨˩
vầng	v ə ŋ ˨˩
vầy	v ə j ˨˩
vẫn	v ə ŋ ˨˩˦
vẫy	v ə j ˨˩˦
vận	v ə ŋ ˨˩˨
vật	v ə k̚ ˨˩˨
vậy	v ə j ˨˩˨
vắng	v a ŋ ˦˥
vắt	v a k̚ ˦˥
vằn	v a ŋ ˨˩
vặc	v a k̚ ˨˩˨
vặn	v a ŋ ˨˩˨
vặt	v a k̚ ˨˩˨
vẹm	v ɛ m ˨˩˨
vẹn	v ɛ ŋ ˨˩˨
vẹo	v ɛ w ˨˩˨
vẹt	v ɛ k̚ ˨˩˨
vẻ	v ɛ ˨˩˦
vẽ	v ɛ ˨˩˦
vế	v e j ˦˥
vết	v əː t̚ ˦˥
vếu	v e w ˦˥
về	v e j ˨˩
vểnh	v əː n ˨˩˦
vệ	v e j ˨˩˨
vện	v əː n ˨˩˨
vệt	v əː t̚ ˨˩˨
vỉ	v ɪ j ˨˩˦
vỉa	v i ə ˨˩˦
vị	v ɪ j ˨˩˨
vịn	v ɨ n ˨˩˨
vịnh	v ɨ n ˨˩˨
vịt	v ɨ t̚ ˨˩˨
vọc	v a w k͡p̚ ˨˩˨
vọng	v a w ŋ͡m ˨˩˨
vọt	v ɔ k̚ ˨˩˨
vỏ	v ɔ ˨˩˦
vốc	v ə w k͡p̚ ˦˥
vốn	v o ŋ ˦˥
vồ	v o w ˨˩
vồng	v ə w ŋ͡m ˨˩
vỗ	v o w ˨˩˦
vội	v o j ˨˩˨
vớ	v əː ˦˥
với	v əː j ˦˥
vớt	v əː k̚ ˦˥
vờ	v əː ˨˩
vời	v əː j ˨˩
vờn	v əː ŋ ˨˩
vở	v əː ˨˩˦
vỡ	v əː ˨˩˦
vợ	v əː ˨˩˨
vợt	v əː k̚ ˨˩˨
vụ	v ʊ w ˨˩˨
vụn	v ʊ w ŋ͡m ˨˩˨
vụng	v ʊ w ŋ͡m ˨˩˨
vụt	v ʊ k͡p̚ ˨˩˨
vứt	v ɨ k̚ ˦˥
vừa	v ɨ ə ˨˩
vừng	v ɨ ŋ ˨˩
vữa	v ɨ ə ˨˩˦
vững	v ɨ ŋ ˨˩˦
vựa	v ɨ ə ˨˩˨
vực	v ɨ k̚ ˨˩˨
x	ʔ ɨ t̚ ˦˥ ʂ ɪ j ˨˩
xa	s aː ˧˧
xanh	s a n ˧˧
xaviê	s aː ˧˧ v ɪ j ˧˧ ʔ e j ˧˧
xay	s aː j ˧˧
xe	s ɛ ˧˧
xem	s ɛ m ˧˧
xen	s ɛ ŋ ˧˧
xenon	s e j ˧˧ n ə w ŋ͡m ˧˧
xeri	s ɛ ˧˧ ɹ ɪ j ˧˧
xesi	s e j ˧˧ s ɪ j ˧˧
xin	s ɨ n ˧˧
xinh	s ɨ n ˧˧
xiêm	s i m ˧˧
xiên	s i ə ŋ ˧˧
xiêu	s i w ˧˧
xiếc	s i ə k̚ ˦˥
xiềng	s i ə ŋ ˨˩
xoa	s ⁽ʷ ⁾ aː ˧˧
xoang	s ⁽ʷ ⁾ aː ŋ ˧˧
xoay	s ⁽ʷ ⁾ a j ˧˧
xoe	s ⁽ʷ ⁾ ɛ ˧˧
xoi	s ɔ j ˧˧
xong	s a w ŋ͡m ˧˧
xoong	s ɔ ŋ ˧˧
xoài	s ⁽ʷ ⁾ aː j ˨˩
xoàn	s ⁽ʷ ⁾ aː ŋ ˨˩
xoá	s ⁽ʷ ⁾ aː ˦˥
xoáy	s ⁽ʷ ⁾ a j ˦˥
xoã	s ⁽ʷ ⁾ aː ˨˩˦
xoè	s ⁽ʷ ⁾ ɛ ˨˩
xoăn	s ⁽ʷ ⁾ a ŋ ˧˧
xoạc	s ⁽ʷ ⁾ aː k̚ ˨˩˨
xoắn	s ⁽ʷ ⁾ a ŋ ˦˥
xtiêng	s t i ə ŋ ˧˧
xu	s ʊ w ˧˧
xua	s u ə ˧˧
xui	s u j ˧˧
xung	s ʊ w ŋ͡m ˧˧
xuyên	s ⁽ʷ ⁾ i ə ŋ ˧˧
xuyến	s ⁽ʷ ⁾ i ə ŋ ˦˥
xuân	s ⁽ʷ ⁾ ə ŋ ˧˧
xuôi	s u j ˧˧
xuýt	s ⁽ʷ ⁾ ɨ t̚ ˦˥
xuất	s ⁽ʷ ⁾ ə k̚ ˦˥
xuống	s u ə ŋ ˦˥
xuồng	s u ə ŋ ˨˩
xà	s aː ˨˩
xài	s aː j ˨˩
xàm	s aː m ˨˩
xào	s aː w ˨˩
xá	s aː ˦˥
xác	s aː k̚ ˦˥
xách	s a t̚ ˦˥
xái	s aː j ˦˥
xám	s aː m ˦˥
xáo	s aː w ˦˥
xát	s aː k̚ ˦˥
xáy	s aː j ˦˥
xâu	s ə w ˧˧
xây	s ə j ˧˧
xã	s aː ˨˩˦
xèng	s ɛ ŋ ˨˩
xèo	s ɛ w ˨˩
xé	s ɛ ˦˥
xém	s ɛ m ˦˥
xén	s ɛ ŋ ˦˥
xéo	s ɛ w ˦˥
xét	s ɛ k̚ ˦˥
xê	s e j ˧˧
xì	s ɪ j ˨˩
xí	s ɪ j ˦˥
xía	s i ə ˦˥
xích	s ɨ t̚ ˦˥
xíu	s i w ˦˥
xó	s ɔ ˦˥
xóc	s a w k͡p̚ ˦˥
xói	s ɔ j ˦˥
xóm	s ɔ m ˦˥
xót	s ɔ k̚ ˦˥
xô	s o w ˧˧
xôi	s o j ˧˧
xông	s ə w ŋ͡m ˧˧
xù	s ʊ w ˨˩
xúc	s ʊ w k͡p̚ ˦˥
xúi	s u j ˦˥
xúm	s ʊ m ˦˥
xúp	s ʊ p̚ ˦˥
xút	s ʊ k͡p̚ ˦˥
xăm	s a m ˧˧
xăng	s a ŋ ˧˧
xơ	s əː ˧˧
xơi	s əː j ˧˧
xưa	s ɨ ə ˧˧
xưng	s ɨ ŋ ˧˧
xương	s ɨ ə ŋ ˧˧
xước	s ɨ ə k̚ ˦˥
xướng	s ɨ ə ŋ ˦˥
xưởng	s ɨ ə ŋ ˨˩˦
xạo	s aː w ˨˩˨
xả	s aː ˨˩˦
xảo	s aː w ˨˩˦
xảy	s aː j ˨˩˦
xấp	s ə p̚ ˦˥
xấu	s ə w ˦˥
xắn	s a ŋ ˦˥
xắt	s a k̚ ˦˥
xẹp	s ɛ p̚ ˨˩˨
xẻ	s ɛ ˨˩˦
xẻng	s ɛ ŋ ˨˩˦
xế	s e j ˦˥
xếch	s əː t̚ ˦˥
xếp	s e p̚ ˦˥
xệ	s e j ˨˩˨
xỉa	s i ə ˨˩˦
xỉn	s ɨ n ˨˩˦
xỉu	s i w ˨˩˦
xị	s ɪ j ˨˩˨
xịn	s ɨ n ˨˩˨
xịt	s ɨ t̚ ˨˩˨
xỏ	s ɔ ˨˩˦
xốc	s ə w k͡p̚ ˦˥
xối	s o j ˦˥
xốp	s o p̚ ˦˥
xốt	s o k̚ ˦˥
xới	s əː j ˦˥
xứ	s ɨ ˦˥
xức	s ɨ k̚ ˦˥
xử	s ɨ ˨˩˦
xực	s ɨ k̚ ˨˩˨
y	ʔ ɪ j ˧˧
y	ʔ ɪ j ˧˧ j aː j ˨˩
ytecbi	ʔ ɪ j ˧˧ t ɛ k̚ ˦˥ ʔ ɓ ɪ j ˧˧
ytri	ʔ ɪ j ˧˧ ʈ ɪ j ˧˧
yên	ʔ i ə ŋ ˧˧
yêu	ʔ i w ˧˧
yếm	ʔ i ə m ˦˥
yến	ʔ i ə ŋ ˦˥
yếu	ʔ i w ˦˥
yểm	ʔ i ə m ˨˩˦
yểu	ʔ i w ˨˩˦
ziriconi	z ɪ j ˧˧ ɹ ɪ j ˧˧ k ɔ ˧˧ n ɪ j ˧˧
à	ʔ aː ˨˩
ào	ʔ aː w ˨˩
á	ʔ aː ˦˥
ác	ʔ aː k̚ ˦˥
ách	ʔ a t̚ ˦˥
ái	ʔ aː j ˦˥
ám	ʔ aː m ˦˥
án	ʔ aː ŋ ˦˥
áng	ʔ aː ŋ ˦˥
ánh	ʔ a n ˦˥
áo	ʔ aː w ˦˥
áp	ʔ aː p̚ ˦˥
át	ʔ aː k̚ ˦˥
â	ʔ əː ˦˥
âm	ʔ ə m ˧˧
ân	ʔ ə ŋ ˧˧
âu	ʔ ə w ˧˧
éc	ʔ ɛ k̚ ˦˥
ém	ʔ ɛ m ˦˥
én	ʔ ɛ ŋ ˦˥
éo	ʔ ɛ w ˦˥
ép	ʔ ɛ p̚ ˦˥
ét	ʔ ɛ k̚ ˦˥
ê	ʔ e j ˧˧
êkip	ʔ e j ˧˧ k i p̚ ˦˥
êm	ʔ e m ˧˧
êtanol	ʔ e j ˧˧ t aː ˧˧ n ɔ ŋ ˧˧
êugêniô	ʔ e w ˧˧ ɣ əː n ˧˧ n ɪ j ˧˧ ʔ o w ˧˧
ì	ʔ ɪ j ˨˩
ích	ʔ ɨ t̚ ˦˥
ít	ʔ ɨ t̚ ˦˥
ítcariốt	ʔ ɨ t̚ ˦˥ k aː ˧˧ ɹ ɪ j ˧˧ ʔ o k̚ ˦˥
ó	ʔ ɔ ˦˥
óc	ʔ a w k͡p̚ ˦˥
ói	ʔ ɔ j ˦˥
óng	ʔ a w ŋ͡m ˦˥
ót	ʔ ɔ k̚ ˦˥
ô	ʔ o w ˧˧
ôbace	ʔ ə w ŋ͡m ˧˧ ʔ ɓ aː ˨˩ ʔ a n ˧˧ c ɪ j ˨˩˨ ʔ ɛ m ˧˧
ôi	ʔ o j ˧˧
ôm	ʔ o m ˧˧
ôn	ʔ o ŋ ˧˧
ông	ʔ ə w ŋ͡m ˧˧
ôzôn	ʔ o w ˧˧ z o n ˧˧
ù	ʔ ʊ w ˨˩
ùn	ʔ ʊ w ŋ͡m ˨˩
ú	ʔ ʊ w ˦˥
úa	ʔ u ə ˦˥
úc	ʔ ʊ w k͡p̚ ˦˥
úi	ʔ u j ˦˥
úng	ʔ ʊ w ŋ͡m ˦˥
úp	ʔ ʊ p̚ ˦˥
út	ʔ ʊ k͡p̚ ˦˥
ý	ʔ ɪ j ˦˥
ă	ʔ aː ˦˥
ăn	ʔ a ŋ ˧˧
đ	ʔ ɗ e j ˧˧
đa	ʔ ɗ aː ˧˧
đai	ʔ ɗ aː j ˧˧
đam	ʔ ɗ aː m ˧˧
đaminh	ʔ ɗ aː ˧˧ m ɨ n ˧˧
đan	ʔ ɗ aː ŋ ˧˧
đang	ʔ ɗ aː ŋ ˧˧
đanh	ʔ ɗ a n ˧˧
đao	ʔ ɗ aː w ˧˧
đau	ʔ ɗ aː w ˧˧
đay	ʔ ɗ aː j ˧˧
đcg	ʔ ɗ ɨ k̚ ˦˥ c u ə ˦˥ j e j ˧˧ ʂ ʊ w ˧˧
đe	ʔ ɗ ɛ ˧˧
đem	ʔ ɗ ɛ m ˧˧
đen	ʔ ɗ ɛ ŋ ˧˧
đeo	ʔ ɗ ɛ w ˧˧
đhy	ʔ ɗ ɨ k̚ ˦˥ h ə w ŋ͡m ˨˩ ʔ ɪ j ˧˧
đi	ʔ ɗ ɪ j ˧˧
đinh	ʔ ɗ ɨ n ˧˧
điprozi	ʔ ɗ i p̚ ˧˧ ɹ ɔ ˧˧ z ɪ j ˧˧
điên	ʔ ɗ i ə ŋ ˧˧
điêu	ʔ ɗ i w ˧˧
điônisiô	ʔ ɗ ɪ j ˧˧ ʔ o ŋ ˧˧ n ɪ j ˧˧ s ɪ j ˧˧ ʔ o w ˧˧
điếc	ʔ ɗ i ə k̚ ˦˥
điếm	ʔ ɗ i m ˦˥
điếu	ʔ ɗ i w ˦˥
điền	ʔ ɗ i ə ŋ ˨˩
điều	ʔ ɗ i w ˨˩
điểm	ʔ ɗ i m ˨˩˦
điển	ʔ ɗ i ə ŋ ˨˩˦
điện	ʔ ɗ i ə ŋ ˨˩˨
điệp	ʔ ɗ i p̚ ˨˩˨
điệu	ʔ ɗ i w ˨˩˨
đm	ʔ ɗ əː ˨˩ m əː ˨˩
đo	ʔ ɗ ɔ ˧˧
đoan	ʔ ɗ w aː ŋ ˧˧
đong	ʔ ɗ a w ŋ͡m ˧˧
đoàn	ʔ ɗ w aː ŋ ˨˩
đoá	ʔ ɗ w aː ˦˥
đoán	ʔ ɗ w aː ŋ ˦˥
đoạn	ʔ ɗ w aː ŋ ˨˩˨
đoạt	ʔ ɗ w aː k̚ ˨˩˨
đoản	ʔ ɗ w aː ŋ ˨˩˦
đtdđ	ʔ ɗ i ə ŋ ˨˩˨ tʰ ⁽ʷ ⁾ aː j ˨˩˨ j ɪ j ˧˧ ʔ ɗ ə w ŋ͡m ˨˩˨
đu	ʔ ɗ ʊ w ˧˧
đua	ʔ ɗ u ə ˧˧
đui	ʔ ɗ u j ˧˧
đun	ʔ ɗ ʊ w ŋ͡m ˧˧
đupni	ʔ ɗ ʊ p̚ ˦˥ n ɪ j ˧˧
đuôi	ʔ ɗ u j ˧˧
đuông	ʔ ɗ u ə ŋ ˧˧
đuốc	ʔ ɗ u ə k̚ ˦˥
đuối	ʔ ɗ u j ˦˥
đuổi	ʔ ɗ u j ˨˩˦
đà	ʔ ɗ aː ˨˩
đài	ʔ ɗ aː j ˨˩
đàm	ʔ ɗ aː m ˨˩
đàn	ʔ ɗ aː ŋ ˨˩
đàng	ʔ ɗ aː ŋ ˨˩
đành	ʔ ɗ a n ˨˩
đào	ʔ ɗ aː w ˨˩
đày	ʔ ɗ aː j ˨˩
đá	ʔ ɗ aː ˦˥
đái	ʔ ɗ aː j ˦˥
đám	ʔ ɗ aː m ˦˥
đán	ʔ ɗ aː ŋ ˦˥
đáng	ʔ ɗ aː ŋ ˦˥
đánh	ʔ ɗ a n ˦˥
đáp	ʔ ɗ aː p̚ ˦˥
đát	ʔ ɗ aː k̚ ˦˥
đáy	ʔ ɗ aː j ˦˥
đâm	ʔ ɗ ə m ˧˧
đâu	ʔ ɗ ə w ˧˧
đây	ʔ ɗ ə j ˧˧
đã	ʔ ɗ aː ˨˩˦
đãi	ʔ ɗ aː j ˨˩˦
đè	ʔ ɗ ɛ ˨˩
đèn	ʔ ɗ ɛ ŋ ˨˩
đèo	ʔ ɗ ɛ w ˨˩
đéo	ʔ ɗ ɛ w ˦˥
đê	ʔ ɗ e j ˧˧
đêm	ʔ ɗ e m ˧˧
đì	ʔ ɗ ɪ j ˨˩
đìa	ʔ ɗ i ə ˨˩
đình	ʔ ɗ ɨ n ˨˩
đía	ʔ ɗ i ə ˦˥
đích	ʔ ɗ ɨ t̚ ˦˥
đính	ʔ ɗ ɨ n ˦˥
đít	ʔ ɗ ɨ t̚ ˦˥
đò	ʔ ɗ ɔ ˨˩
đòi	ʔ ɗ ɔ j ˨˩
đòm	ʔ ɗ ɔ m ˨˩
đòn	ʔ ɗ ɔ ŋ ˨˩
đó	ʔ ɗ ɔ ˦˥
đói	ʔ ɗ ɔ j ˦˥
đón	ʔ ɗ ɔ ŋ ˦˥
đóng	ʔ ɗ a w ŋ͡m ˦˥
đô	ʔ ɗ o w ˧˧
đôi	ʔ ɗ o j ˧˧
đông	ʔ ɗ ə w ŋ͡m ˧˧
đù	ʔ ɗ ʊ w ˨˩
đùa	ʔ ɗ u ə ˨˩
đùi	ʔ ɗ u j ˨˩
đùm	ʔ ɗ ʊ m ˨˩
đùng	ʔ ɗ ʊ w ŋ͡m ˨˩
đú	ʔ ɗ ʊ w ˦˥
đúc	ʔ ɗ ʊ w k͡p̚ ˦˥
đúng	ʔ ɗ ʊ w ŋ͡m ˦˥
đúp	ʔ ɗ ʊ p̚ ˦˥
đút	ʔ ɗ ʊ k͡p̚ ˦˥
đăm	ʔ ɗ a m ˧˧
đăng	ʔ ɗ a ŋ ˧˧
đĩ	ʔ ɗ ɪ j ˨˩˦
đĩa	ʔ ɗ i ə ˨˩˦
đũa	ʔ ɗ u ə ˨˩˦
đũng	ʔ ɗ ʊ w ŋ͡m ˨˩˦
đũy	ʔ ɗ w ɪ j ˨˩˦
đơ	ʔ ɗ əː ˧˧
đơm	ʔ ɗ əː m ˧˧
đơn	ʔ ɗ əː ŋ ˧˧
đưa	ʔ ɗ ɨ ə ˧˧
đương	ʔ ɗ ɨ ə ŋ ˧˧
đước	ʔ ɗ ɨ ə k̚ ˦˥
đường	ʔ ɗ ɨ ə ŋ ˨˩
được	ʔ ɗ ɨ ə k̚ ˨˩˨
đượm	ʔ ɗ ɨ ə m ˨˩˨
đạc	ʔ ɗ aː k̚ ˨˩˨
đại	ʔ ɗ aː j ˨˩˨
đạm	ʔ ɗ aː m ˨˩˨
đạn	ʔ ɗ aː ŋ ˨˩˨
đạo	ʔ ɗ aː w ˨˩˨
đạp	ʔ ɗ aː p̚ ˨˩˨
đạt	ʔ ɗ aː k̚ ˨˩˨
đả	ʔ ɗ aː ˨˩˦
đảm	ʔ ɗ aː m ˨˩˦
đảng	ʔ ɗ aː ŋ ˨˩˦
đảo	ʔ ɗ aː w ˨˩˦
đấm	ʔ ɗ ə m ˦˥
đấng	ʔ ɗ ə ŋ ˦˥
đất	ʔ ɗ ə k̚ ˦˥
đấu	ʔ ɗ ə w ˦˥
đấy	ʔ ɗ ə j ˦˥
đầm	ʔ ɗ ə m ˨˩
đần	ʔ ɗ ə ŋ ˨˩
đầu	ʔ ɗ ə w ˨˩
đầy	ʔ ɗ ə j ˨˩
đẩu	ʔ ɗ ə w ˨˩˦
đẩy	ʔ ɗ ə j ˨˩˦
đẫm	ʔ ɗ ə m ˨˩˦
đẫy	ʔ ɗ ə j ˨˩˦
đậm	ʔ ɗ ə m ˨˩˨
đập	ʔ ɗ ə p̚ ˨˩˨
đậu	ʔ ɗ ə w ˨˩˨
đậy	ʔ ɗ ə j ˨˩˨
đắm	ʔ ɗ a m ˦˥
đắng	ʔ ɗ a ŋ ˦˥
đắp	ʔ ɗ a p̚ ˦˥
đắt	ʔ ɗ a k̚ ˦˥
đằm	ʔ ɗ a m ˨˩
đằng	ʔ ɗ a ŋ ˨˩
đẳng	ʔ ɗ a ŋ ˨˩˦
đặc	ʔ ɗ a k̚ ˨˩˨
đặng	ʔ ɗ a ŋ ˨˩˨
đặt	ʔ ɗ a k̚ ˨˩˨
đẹp	ʔ ɗ ɛ p̚ ˨˩˨
đẹt	ʔ ɗ ɛ k̚ ˨˩˨
đẻ	ʔ ɗ ɛ ˨˩˦
đẻn	ʔ ɗ ɛ ŋ ˨˩˦
đẽo	ʔ ɗ ɛ w ˨˩˦
đế	ʔ ɗ e j ˦˥
đếch	ʔ ɗ əː t̚ ˦˥
đếm	ʔ ɗ e m ˦˥
đến	ʔ ɗ əː n ˦˥
đề	ʔ ɗ e j ˨˩
đền	ʔ ɗ əː n ˨˩
đều	ʔ ɗ e w ˨˩
để	ʔ ɗ e j ˨˩˦
đểu	ʔ ɗ e w ˨˩˦
đệ	ʔ ɗ e j ˨˩˨
đệm	ʔ ɗ e m ˨˩˨
đệt	ʔ ɗ əː t̚ ˨˩˨
đỉa	ʔ ɗ i ə ˨˩˦
đỉnh	ʔ ɗ ɨ n ˨˩˦
địch	ʔ ɗ ɨ t̚ ˨˩˨
định	ʔ ɗ ɨ n ˨˩˨
địt	ʔ ɗ ɨ t̚ ˨˩˨
đọ	ʔ ɗ ɔ ˨˩˨
đọc	ʔ ɗ a w k͡p̚ ˨˩˨
đọi	ʔ ɗ ɔ j ˨˩˨
đọng	ʔ ɗ a w ŋ͡m ˨˩˨
đọt	ʔ ɗ ɔ k̚ ˨˩˨
đỏ	ʔ ɗ ɔ ˨˩˦
đỏm	ʔ ɗ ɔ m ˨˩˦
đố	ʔ ɗ o w ˦˥
đốc	ʔ ɗ ə w k͡p̚ ˦˥
đối	ʔ ɗ o j ˦˥
đốm	ʔ ɗ o m ˦˥
đốn	ʔ ɗ o ŋ ˦˥
đống	ʔ ɗ ə w ŋ͡m ˦˥
đốt	ʔ ɗ o k̚ ˦˥
đồ	ʔ ɗ o w ˨˩
đồi	ʔ ɗ o j ˨˩
đồn	ʔ ɗ o ŋ ˨˩
đồng	ʔ ɗ ə w ŋ͡m ˨˩
đổ	ʔ ɗ o w ˨˩˦
đổi	ʔ ɗ o j ˨˩˦
đỗ	ʔ ɗ o w ˨˩˦
đỗi	ʔ ɗ o j ˨˩˦
độ	ʔ ɗ o w ˨˩˨
độc	ʔ ɗ ə w k͡p̚ ˨˩˨
đội	ʔ ɗ o j ˨˩˨
độn	ʔ ɗ o ŋ ˨˩˨
động	ʔ ɗ ə w ŋ͡m ˨˩˨
đột	ʔ ɗ o k̚ ˨˩˨
đớ	ʔ ɗ əː ˦˥
đới	ʔ ɗ əː j ˦˥
đớn	ʔ ɗ əː ŋ ˦˥
đớp	ʔ ɗ əː p̚ ˦˥
đờ	ʔ ɗ əː ˨˩
đời	ʔ ɗ əː j ˨˩
đờm	ʔ ɗ əː m ˨˩
đờn	ʔ ɗ əː ŋ ˨˩
đỡ	ʔ ɗ əː ˨˩˦
đợi	ʔ ɗ əː j ˨˩˨
đợt	ʔ ɗ əː k̚ ˨˩˨
đụ	ʔ ɗ ʊ w ˨˩˨
đục	ʔ ɗ ʊ w k͡p̚ ˨˩˨
đụn	ʔ ɗ ʊ w ŋ͡m ˨˩˨
đụng	ʔ ɗ ʊ w ŋ͡m ˨˩˨
đụt	ʔ ɗ ʊ k͡p̚ ˨˩˨
đủ	ʔ ɗ ʊ w ˨˩˦
đứa	ʔ ɗ ɨ ə ˦˥
đức	ʔ ɗ ɨ k̚ ˦˥
đứng	ʔ ɗ ɨ ŋ ˦˥
đứt	ʔ ɗ ɨ k̚ ˦˥
đừng	ʔ ɗ ɨ ŋ ˨˩
đực	ʔ ɗ ɨ k̚ ˨˩˨
đựng	ʔ ɗ ɨ ŋ ˨˩˨
ơ	ʔ əː ˧˧
ơi	ʔ əː j ˧˧
ơn	ʔ əː ŋ ˧˧
ư	ʔ ɨ ˧˧
ưa	ʔ ɨ ə ˧˧
ưng	ʔ ɨ ŋ ˧˧
ươi	ʔ ɨ j ˧˧
ươn	ʔ ɨ ə ŋ ˧˧
ước	ʔ ɨ ə k̚ ˦˥
ướp	ʔ ɨ ə p̚ ˦˥
ướt	ʔ ɨ ə k̚ ˦˥
ạ	ʔ aː ˨˩˨
ả	ʔ aː ˨˩˦
ải	ʔ aː j ˨˩˦
ảnh	ʔ a n ˨˩˦
ảo	ʔ aː w ˨˩˦
ấm	ʔ ə m ˦˥
ấn	ʔ ə ŋ ˦˥
ấp	ʔ ə p̚ ˦˥
ất	ʔ ə k̚ ˦˥
ấu	ʔ ə w ˦˥
ấy	ʔ ə j ˦˥
ầm	ʔ ə m ˨˩
ẩm	ʔ ə m ˨˩˦
ẩn	ʔ ə ŋ ˨˩˦
ẩu	ʔ ə w ˨˩˦
ập	ʔ ə p̚ ˨˩˨
ắp	ʔ a p̚ ˦˥
ắt	ʔ a k̚ ˦˥
ẳng	ʔ a ŋ ˨˩˦
ẵm	ʔ a m ˨˩˦
ẹ	ʔ ɛ ˨˩˨
ẹp	ʔ ɛ p̚ ˨˩˨
ẻm	ʔ ɛ m ˨˩˦
ế	ʔ e j ˦˥
ếch	ʔ əː t̚ ˦˥
ềnh	ʔ əː n ˨˩
ễnh	ʔ əː n ˨˩˦
ỉa	ʔ i ə ˨˩˦
ỉm	ʔ i m ˨˩˦
ỉn	ʔ ɨ n ˨˩˦
ỉu	ʔ i w ˨˩˦
ị	ʔ ɪ j ˨˩˨
ịch	ʔ ɨ t̚ ˨˩˨
ịn	ʔ ɨ n ˨˩˨
ịt	ʔ ɨ t̚ ˨˩˨
ọe	ʔ w ɛ ˨˩˨
ốc	ʔ ə w k͡p̚ ˦˥
ối	ʔ o j ˦˥
ốm	ʔ o m ˦˥
ống	ʔ ə w ŋ͡m ˦˥
ốp	ʔ o p̚ ˦˥
ồ	ʔ o w ˨˩
ồn	ʔ o ŋ ˨˩
ổ	ʔ o w ˨˩˦
ổi	ʔ o j ˨˩˦
ổn	ʔ o ŋ ˨˩˦
ổng	ʔ ə w ŋ͡m ˨˩˦
ộp	ʔ o p̚ ˨˩˨
ớ	ʔ əː ˦˥
ớn	ʔ əː ŋ ˦˥
ớt	ʔ əː k̚ ˦˥
ờ	ʔ əː ˨˩
ở	ʔ əː ˨˩˦
ợ	ʔ əː ˨˩˨
ụ	ʔ ʊ w ˨˩˨
ủ	ʔ ʊ w ˨˩˦
ủa	ʔ u ə ˨˩˦
ủi	ʔ u j ˨˩˦
ủng	ʔ ʊ w ŋ͡m ˨˩˦
ứ	ʔ ɨ ˦˥
ứa	ʔ ɨ ə ˦˥
ức	ʔ ɨ k̚ ˦˥
ứng	ʔ ɨ ŋ ˦˥
ừ	ʔ ɨ ˨˩
ừa	ʔ ɨ ə ˨˩
ừm	ʔ ɨ m ˨˩
ửng	ʔ ɨ ŋ ˨˩˦
ực	ʔ ɨ k̚ ˨˩˨
